事態の打開へ、厚生労働省もメーカーに供給増などの対応を取るよう要請を始めた。	<政府活動>,<日本>,<法整備・規制>
深刻さを増す日本の科学研究力低下に対応し、政府は10兆円規模の大学ファンドを設けて大学の研究支援に踏み切る。	<政府活動>,<日本>,<税制・予算>
日本政府は4月、30年度に温暖化ガス排出を13年度比46%減らす目標を打ち出した。	<政府活動>,<日本>,<目標・計画・指針>
総額2兆円におよぶ政府の「グリーンイノベーション基金事業」の一環として、東芝や積水化学工業、東京大学などによる計6件の研究テーマを支援する。	
経済産業省が28日発表した11月の鉱工業生産指数では自動車工業の国内生産が前月比43.1%上昇となり、7月の水準まで回復した。	<政府活動>,<日本>,<指数・統計>
観光庁は同日、2社を「Go To」再開時に参加停止にすると発表。	<政府活動>,<日本>,<法整備・規制>
中国政府が12月初めに国連宇宙空間平和利用委員会に提出した書面をもとに、ロイター通信が最初に報じた。	<企業活動背景>,<中国>,<法整備・規制>,<施行>
国土交通省はすでに1年延長を認めている北海道エアポートの空港運営事業期間をさらに1年延長し、32年間とすると発表した。	<政府活動>,<日本>,<その他>
デジタル庁は2025年度末までに政府共通の「ガバメントクラウド」を整備し、自治体の税や住民基本台帳などの業務基幹システムを移す方針だ。	<政府活動>,<日本>,<目標・計画・指針>
各国政府がガソリン車販売への規制を強めるなか、電気自動車の普及が加速している。	<企業活動背景>,<日本>,<法整備・規制>
政府は27日、原燃料費や人件費の上昇を踏まえ、下請けなど中小企業が価格転嫁しやすくする対策をまとめた。	<政府活動>,<日本>,<法整備・規制>,<検討>
企業の経理のデジタル化を巡り、国税庁は電子データで受け取った請求書などの電子保存義務を2年間猶予する際に企業からの事前申請を不要にする方針だ。	<政府活動>,<日本>,<法整備・規制>
中国政府は27日、2022年に外資系自動車メーカーの乗用車分野の出資規制を撤廃すると発表した。	<政府活動>,<中国>,<法整備・規制>,<廃止>
中国の経済政策をかじ取りする国家発展改革委員会と商務省が同日発表した、外資企業の参入を制限する分野を定めた「ネガティブリスト」から乗用車を外した。	<政府活動>,<日本>,<法整備・規制>
農林水産省が24日発表した2020年の農業産出額で茨城県は前年比3%増の4411億円と都道府県別で4年連続の3位だった。	<政府活動>,<日本>,<指数・統計>
政府が24日閣議決定した2022年度予算案によると、北海道開発予算は21年度当初予算比で微減の5702億円だった。	<政府活動>,<日本>,<税制・予算>
政府は24日、2022年度予算案を閣議決定した。	<政府活動>,<日本>,<税制・予算>,<施行>
経済産業省と国土交通省は24日、秋田県沖と千葉県沖の3つの海域で洋上風力発電を担う事業者の公募結果を発表した。	<政府活動>,<日本>,<補助金・交付金>
政府は40年にすべての小型トラックを電動車にする方針だ。	<政府活動>,<日本>,<目標・計画・指針>
米製薬大手メルクが開発する新型コロナウイルスの飲み薬「モルヌピラビル」について、厚生労働省の専門部会は24日午後、承認の可否を審議する。	<政府活動>,<米国>,<法整備・規制>,<検討>
既に英国と米国では使用が認められており、日本政府は約160万回分の供給契約を結んでいる。	<政府活動>,<日本>,<その他>
政府は人権侵害に使われる恐れがある先端の監視技術について米欧などと連携し、輸出規制を検討する。	<政府活動>,<日本>,<法整備・規制>,<検討>
中国政府は23日、国有のレアアース専業会社を設立したと発表した。	<政府活動>,<中国>,<その他>
金融庁は23日、監査法人が上場会社の会計監査を担うための法的効力を持つ登録制度を導入する方針を固めた。	<政府活動>,<日本>,<法整備・規制>,<施行>
経済産業省は23日、2022年1~3月期の国内粗鋼生産量が前年同期比1.9%増の2415万トンになるとの見通しを発表した。	<政府活動>,<日本>,<指数・統計>
地方を中心に、官公庁の工事が大幅に伸びた。	
官公庁受注は25.4%増の2704億円で、8月以来3カ月ぶりに増えた。	<政府活動>,<日本>,<指数・統計>
厚生労働省の専門部会が継続審議としたことは、認知症が複雑な病で治療に道筋をつけることが非常に困難なことを示している。	<企業活動背景>,<日本>,<法整備・規制>,<検討>
地政学リスクなどの影響を受けない独自のサプライチェーン構築を狙う中国政府の後押しを受け、台湾勢が目立ってきたアップルのサプライチェーンで中国勢の勢いが増しそうだ。	
資源エネルギー庁は22日、レギュラーガソリンの店頭価格が1リットル165.1円と前週比0.8円安くなったと発表した。	<政府活動>,<日本>,<指数・統計>
厚生労働省の専門部会は22日、エーザイと米バイオジェンが共同開発した認知症の新薬「アデュヘルム」の承認判断について審議を継続する方針を示した。	<政府活動>,<米国>,<法整備・規制>,<検討>
厚生労働省からの承認が下り、2回目接種から8カ月後の3月中旬の開始に向けて準備を始めた。	
さらに政府の統計が運び手の変化に対応できず、計上されない「隠れ宅配」が数億個単位で膨らんでいる。	
エーザイと米バイオジェンが共同で開発したアルツハイマー病新薬「アデュヘルム」について、厚生労働省の専門部会は22日午後4時から承認の可否を審議する。	<政府活動>,<米国>,<法整備・規制>,<検討>
症状の進行を抑える画期的な新薬との期待が高い一方で、承認の判断は米欧で分かれており、厚労省の判断が注目される。	
政府は酒類の安売り規制を強化する。	<政府活動>,<日本>,<法整備・規制>
英国政府は環境対策「グリーン産業革命」の中でEVへのシフトを柱の1つにしている。	<政府活動>,<英国>,<その他>
--政府は3回目接種までの期間を短縮する方針です。	<政府活動>,<日本>,<目標・計画・指針>
タイ政府は、23日に予定していた首都バンコクの鉄道ターミナル駅の機能移転について延期を決めた。	<政府活動>,<タイ>,<目標・計画・指針>
経済への影響を懸念する政府は国際線の定期便を再開させたい考えだが、医療体制が脆弱なため、難しい判断を迫られている。	<企業活動背景>,<日本>,<その他>
静岡ガスは国内で培った省エネ技術をIRMエナジーに提供し、産業用天然ガス需要を開拓する。	
新拠点は政府のデジタルトランスフォーメーションやプライバシーを守る技術など、従来の専門分野を超えた横断的なテーマを研究する。	
消費者庁は2022年にインターネットのサイト形式で商品を紹介する「アフィリエイト広告」について指針を策定する方針だ。	<政府活動>,<日本>,<目標・計画・指針>
世界的な脱炭素の流れを意識し、60年までに二酸化炭素排出量の実質ゼロを目標に掲げる中国政府の方針に対応する。	<企業活動背景>,<中国>,<目標・計画・指針>
議長役を務める欧州連合欧州対外活動庁のモラ事務局次長は協議後、記者団に「私たちにはあまり時間がなく、明らかに緊急性を感じている」と述べた。	<政府活動>,<欧州>,<その他>
農林水産省が示す需給の見通しや産地の意向をもとに設定した。	<企業活動背景>,<日本>,<目標・計画・指針>
農林水産省が17日発表した2021年産米の11月分の相対取引価格は1俵あたりの全銘柄平均で1万3024円と、前年同月に比べ13%下がった。	<政府活動>,<日本>,<指数・統計>
エーザイと米バイオジェンは17日、共同開発したアルツハイマー病新薬「アデュヘルム」について、欧州連合での新薬認可を判断する欧州医薬品庁の評価委員会が販売承認しないと勧告したと発表した。	<政府活動>,<米国>,<法整備・規制>
政府も2030年までに大学の9割でオンライン教育が可能になるといった環境を整備する方針を打ち出した。	<政府活動>,<日本>,<目標・計画・指針>
世界的にエネルギー価格の高騰が続き、タイでトラック輸送業界と政府の確執が深まっている。	
日本政府は既に1億5000万回分の供給を受ける契約を結んでいる。	<政府活動>,<日本>,<その他>
取締役と執行役が行政庁の幹部職員と接触した場合には概要を記録に残すことなどを盛り込んだ。	
英政府は15日、電気自動車の購入補助金を下げると発表した。	<政府活動>,<英国>,<補助金・交付金>
経済産業省は15日、太陽光と風力による発電を抑える出力制御が2022年度に北海道、東北、四国、九州、沖縄の5地域で発生するとの試算をまとめた。	<政府活動>,<日本>,<その他>
同省が電力会社の翌年度の出力制御の見通しをまとめたのは初めて。	<政府活動>,<日本>,<その他>
一方、当初は同公園への移転を予定していた清水区の新庁舎計画は見通せないままだ。	
資源エネルギー庁は15日、レギュラーガソリンの店頭価格が1リットル165.9円となり、5週連続で値下がりしたと発表した。	<政府活動>,<日本>,<指数・統計>
中国政府は2022年2月に開幕する北京冬季五輪・パラリンピックに向け、北京市など北部で大気汚染対策を強化する。	<政府活動>,<中国>,<法整備・規制>
地方も同調し、河北省唐山市政府は期間中、大気汚染につながる物質の排出量を4割以上減らす。	
日産と現地の労働組合、スペイン政府などが共同声明で明らかにした。	<政府活動>,<スペイン>,<その他>
政府は利用者の乗り換えを妨げるとして、各社に改善を求めていた。	<政府活動>,<日本>,<法整備・規制>
韓国政府は外務省内に経済安全保障の専門部署を新設する計画だ。	<政府活動>,<韓国>,<その他>
農林水産省が14日に発表した食品価格動向調査によると12月6日の週の野菜小売価格は、調査対象の8品目のうちハクサイやキャベツ、レタスなど6品目が前週比で値下がりした。	<政府活動>,<日本>,<指数・統計>
水産庁は14日、クロマグロ沿岸漁業の北海道の2022年漁獲枠について、大型魚は前年比10%増の319.6トンに決めた。	<政府活動>,<日本>,<法整備・規制>
再開発資金はJR北海道が融資で調達し、利払いは政府が鉄道建設・運輸施設整備支援機構を通して負担する方向で検討している。	<政府活動>,<日本>,<補助金・交付金>
国際医療福祉大学の和田耕治教授は、オミクロン型の重症化リスクが重要だとみており、それが判明した場合にどのように感染対策などを修正するのか、政府は事前に決めておくべきだと指摘する。	
米アマゾン・ドット・コムなどIT各社も影響の可能性を発表しており、政府も欠陥の修正などの対応を求めている。	<政府活動>,<米国>,<法整備・規制>
経済産業省は燃やしても二酸化炭素を排出しない水素やアンモニアを燃料とする火力発電所の新設を支援する。	<政府活動>,<日本>,<補助金・交付金>
厚生労働省は13日、新型コロナウイルスワクチンの3回目の職場接種に参加する企業や大学の募集を始めた。	<政府活動>,<日本>,<補助金・交付金>
滑走路を新設するには政府が中部空港の基本計画を変更する必要がある。	
滑走路を新設するには政府が中部国際空港の基本計画を変更する必要がある。	
日本政府が巨額の補助金を用意してまで誘致したTSMCの新工場を将来にどうつなげるか。	<企業活動背景>,<日本>,<補助金・交付金>
唐突かもしれないが、そんな問題提起をしたのは、ほかならぬ経済産業省だ。	
中国政府が自国のテック企業への締め付けを強めており、SVFの主要出資先である中国企業は価値が低下している。	<企業活動背景>,<中国>,<目標・計画・指針>
企業にとり感染症薬の事業リスクは高く、危機感を強めた政府もようやく重い腰を上げ始めた。	<政府活動>,<日本>,<その他>
政府系企業などが関与する投資ファンドの連合に決まった。	
継承先は10月に7陣営に絞られたが、中国インターネット通販最大手のアリババ集団などは敗れ、政府が関与する格好で再建が進むことになった。	
九州南部を中心に県独自の観光振興策が寄与しているとみられ、政府の観光需要喚起策「Go To、トラベル」が実施されていた前年同月を上回る高水準が続いている。	
電気自動車の購入に対する政府の補助金がテコとなり、販売が伸びた。	
中国政府はスマートフォンで使う合計106のアプリが個人情報保護法などに違反していると発表した。	<政府活動>,<中国>,<その他>
ネット企業などを所轄する工業情報化省が通知を出した。	<政府活動>,<日本>,<その他>
ノココタウンは広さ2.4ヘクタール、住宅は3000万円台後半が中心で、全棟に太陽光発電システムを搭載して断熱性も高めるなどの省エネ性能が特徴。	
国内では新型コロナウイルス禍に対応した政府の補助金も受注額の増加を後押ししている。	<企業活動背景>,<日本>,<その他>
大日本住友製薬は9日、主力の抗精神病薬「ラツーダ」の特許の一部について、米国特許商標庁が特許性がないとする決定を出したと発表した。	<政府活動>,<米国>,<その他>
健康や環境への意識が高い若い世代が域内で増えていることが追い風で、政府や投資マネーも成長を後押しする。	<企業活動背景>,<日本>,<その他>
政府が11月に「県民割」の国庫補助対象を隣県に広げると発表したことに対応した。	<企業活動背景>,<日本>,<目標・計画・指針>
政府・与党が住宅ローンの金利負担を軽減する「住宅ローン減税」の見直しを進める中、住宅関連事業の先行きに警戒感が広がった。	<企業活動背景>,<日本>,<その他>
RE100は環境関連の国際的な非政府組織が運営している。	
農林水産省は8日、2021年産の主食用米収穫量は700万7000トンでほぼ固まったと発表した。	<政府活動>,<日本>,<指数・統計>
財務省は8日、政府が保有する東京地下鉄の株式を一部売却すると発表した。	<政府活動>,<日本>,<補助金・交付金>
メトロ株は2020年度末時点で政府が53.4%、東京都が46.6%保有している。	
2回目との間隔について、政府の方針は8カ月か6カ月かで二転三転した。	<企業活動背景>,<日本>,<その他>
新型コロナウイルス禍で事業の効率改善を急ぐなか、業務のデジタル化や車内放送の一部省略が進み対応できると判断した。	
農林水産省が7日に発表した食品価格動向調査によると11月29日の週の野菜小売価格は、調査対象の8品目のうちタマネギとトマトが前週比で値上がりした。	<政府活動>,<日本>,<指数・統計>
経済産業省は発電能力があるのに活用しきれていない太陽光や風力発電を減らす対策を強化する。	<政府活動>,<日本>,<法整備・規制>
米エネルギー省のターク副長官は6日、ヒューストンで開催された世界石油会議で、「石油・ガスの国内企業のリーダーシップが必要とされている。国内総生産は成長し、石油・ガス業界の利益水準は回復しているのに、生産が回復していない」などと述べ、石油会社に生産量を増やすように促した。	<政府活動>,<日本>,<指数・統計>
政府は新型コロナウイルスのワクチンの2回目接種を終えた人に対し3回目の接種を始めた。	<政府活動>,<日本>,<その他>
欧州連合の医薬品規制当局である欧州医薬品庁は6日、新型コロナウイルスの重症患者向けにスイスの製薬大手ロシュの関節リウマチ薬「ロアクテムラ」を治療薬として使用できるよう勧告した。	<政府活動>,<欧州>,<法整備・規制>
政府が経済安全保障の法整備を2段階に分けて進めることが分かった。	<政府活動>,<日本>,<法整備・規制>,<検討>
外国人の入国は政府が11月30日から原則停止している。	<政府活動>,<日本>,<法整備・規制>,<廃止>
厚生労働省も変異型の疑いを調べてゲノム解析につなげる「スクリーニング検査」を再開するよう自治体に要請した。	<政府活動>,<日本>,<法整備・規制>
それがオミクロンの出現で「多くの政府がパニックに陥った」ことで、航空業界の回復が遅れることを懸念する。	
デジタルを活用した大学や高専の教育高度化を支援する文部科学省の事業の採択を受け、21年10月にデータ解析ができる仕組みを整えた。	
政府は1日から1日あたり入国者数の上限を3500人に減らしており、各社はこの範囲内で新規の予約を再び受け付ける見通し。	<企業活動背景>,<日本>,<目標・計画・指針>
外国人については11月30日に政府が全世界からの入国を原則停止している。	<政府活動>,<日本>,<法整備・規制>,<廃止>
政府は日本に到着するすべての国際線の新規予約を一律停止するよう要請したが、2日に撤回した。	<企業活動背景>,<日本>,<法整備・規制>,<廃止>
国土交通省が1日までに出していた新規予約の一律受け付けの停止要請を見直し、邦人の帰国需要に配慮するよう2日午前に通知したことを受けた。	<企業活動背景>,<日本>,<法整備・規制>,<検討>,<改正>
原油価格の高騰が続く中、石油元売り各社や政府がガソリン価格の動向に神経をとがらせている。	
約90億円を投じ、経済産業省からの補助金も活用する。	
国税庁は4月、輸出用に限り日本酒の製造要件を緩和し、同社は5月に全国で初めて製造免許を取得していた。	<企業活動背景>,<日本>,<法整備・規制>
国土交通省は新型コロナウイルスの新たな変異型「オミクロン型」の水際対策として、日本に到着する全ての国際線の新規予約を12月末まで停止するよう国内外の航空会社に要請した。	<政府活動>,<日本>,<法整備・規制>,<廃止>
政府は1日、オミクロン型の国内2例目の感染を確認したとも発表。	<政府活動>,<日本>,<その他>
資源エネルギー庁は1日、レギュラーガソリンの店頭価格が前週に比べ0.1円安い1リットル168.6円だったと発表した。	<政府活動>,<日本>,<指数・統計>
国土交通省は新型コロナウイルス「オミクロン型」に対する水際対策を強めるため、日本に到着するすべての国際線について新規予約を停止するよう国内外の航空会社に要請した。	<政府活動>,<日本>,<法整備・規制>,<廃止>
国交省は「オミクロン型の実態が分かるまで感染拡大を食い止めるための緊急避難的な予防措置」だとしている。	<政府活動>,<日本>,<目標・計画・指針>
公表した「ダスグプタ・レビュー」は英財務省がケンブリッジ大学名誉教授に依頼し、経済活動と自然の関わりを分析したものだ。	
英財務省が公表した報告書「ダスグプタ・レビュー」について、和訳を監修した和田喜彦・同志社大学教授はこんな見方を示す。	<企業活動背景>,<英国>,<目標・計画・指針>
東京工業大学のファム・ナム・ハイ准教授と米カリフォルニア大学ロサンゼルス校などは、電子が持つ磁石の性質を利用したMRAMの省電力技術を開発した。	
茨城では多発する災害への対応に加え、高齢化が進む建設業の省力化も課題だ。	
英国の競争・市場庁は30日、米メタに対し、2020年に買収したGIF画像共有サービス大手の米ジフィーを売却するよう命じた。	<政府活動>,<英国>,<法整備・規制>
総務省はターゲティング広告など利用者のデータ提供に関するルール整備に乗り出す。	<政府活動>,<日本>,<その他>
香港政府がまとめた2021年版の「境外企業調査」によると、6月時点で香港に地域統括本部を置く米国企業は254社と、18年ぶりの低い水準に落ち込んだ。	<政府活動>,<香港>,<指数・統計>
上場企業を対象にした政府の調査で、サプライチェーン上の人権侵害リスクを把握する「人権デューデリジェンス」に取り組んでいる企業が52%だったことがわかった。	<政府活動>,<日本>,<指数・統計>
政府は調査結果を踏まえて今後の政策対応を検討する方針だ。	<政府活動>,<日本>,<法整備・規制>,<検討>
政府はアリババを筆頭にネット大手に対する統制の手を緩める気配はない。	
金子恭之総務相や萩生田光一経済産業相らがビデオメッセージを寄せたほか、企業や大学、政府の関係者らが出席し、デジタル変革やサイバー防衛策などを議論した。	<政府活動>,<日本>,<国際会議・会合・会談>
日本政府は26日、南アフリカといった6カ国からの入国者について、10日間の待機を求める措置を発表した。	<政府活動>,<日本>,<法整備・規制>,<施行>
官公庁工事が前月に引き続き落ち込んだが、民間では輸送用機械など製造業が大幅に伸びた。	
子ども関連の政策を議論する政府の有識者会議は29日、岸田文雄首相に報告書を提出した。	<政府活動>,<日本>,<法整備・規制>,<施行>
政府は報告書を踏まえ、年末までに子ども政策を一元的に担う「子ども庁」に関する基本方針をまとめる。	<政府活動>,<日本>,<目標・計画・指針>
日本政府は160万人分の供給契約を結び、ワクチンに続く対策の切り札と期待する。	<政府活動>,<日本>,<その他>
太陽光発電で再生可能エネルギーを底上げする日本政府の戦略にも影響が出かねない。	
水産庁はこのほど「水産物・水産加工品の適正取引推進ガイドライン」を公表した。	<政府活動>,<日本>,<目標・計画・指針>
総務省の調査は行政の現場に多数ある定型作業を効率化するAI導入を調べたもの。	<政府活動>,<日本>,<その他>
石油連盟の杉森務会長は定例記者会見で、政府が石油元売り会社などに補助金を支給する措置について「石油業界として政府と連携していきたい」との認識を示した。	<企業活動背景>,<日本>,<その他>
政府は小売価格の全国平均が1リットルあたり170円を超えた場合に石油元売りなどに補助金を出す。	<政府活動>,<日本>,<補助金・交付金>
資源エネルギー庁は25日、レギュラーガソリンの店頭価格が前週に比べ0.2円安い1リットル168.7円だったと発表した。	<政府活動>,<日本>,<指数・統計>
9月末に緊急事態宣言などが解除されたことで、政府の外食需要喚起策「Go To、イート」があった前年同月の水準までほぼ戻った。	
資源エネルギー庁は25日、レギュラーガソリンの店頭価格が1リットル168.7円だったと発表した。	<政府活動>,<日本>,<指数・統計>
特許庁がまとめた報告書を参考に、世界の技術開発動向などを探った。	<企業活動背景>,<日本>,<法整備・規制>
スペイン政府は20年以上も前から気候変動対策を優先課題と考え、再生可能エネルギーへの転換に取りかかった。	<政府活動>,<スペイン>,<その他>
中国国営中央テレビ系のネットメディア、央視新聞などによると、工業情報化省はテンセントが新たに公開するアプリや既存アプリの機能更新に関して技術検査を実施する。	<政府活動>,<日本>,<その他>
強権的な政府が反体制派などを抑圧するためのツールを提供している同社を「危険な存在」と非難し、裁判所にアップルのソフトウエアや端末などの使用を禁じる命令を出すよう求めている。	<政府活動>,<日本>,<法整備・規制>
インド政府が老朽化した車両の買い替えを促す「廃車政策」の導入を予定するなか、マルチ・スズキの販売網なども生かして中古車を仕入れ、素材の再利用につなげる。	<企業活動背景>,<インド>,<目標・計画・指針>
「本当にもったいないプロジェクトだった。鈴木さんが意図し、実現にこぎつけた新しい通信サービスは、将来の通信状況の変化を予見した素晴らしい発想で、技術も伴っていた。にもかかわらず、理解をしていたはずの大企業も政府も、実質的には見捨てた」	
西九州新幹線の新鳥栖-武雄温泉間の整備方式を巡り、佐賀県と国土交通省は22日、5回目の「幅広い協議」を県庁で開いた。	<政府活動>,<日本>,<国際会議・会合・会談>
従来のJR佐賀駅経由に加え、佐賀空港経由、佐賀市北部沿いの計3ルートをフル規格で整備した場合の利点と課題を国交省がそれぞれ説明した。	<政府活動>,<日本>,<目標・計画・指針>
経済効果などから、政府与党が推す佐賀駅経由ルートが「ベストな選択肢」とした。	<企業活動背景>,<日本>,<その他>
「使い勝手が悪い」との指摘もあり、消費者庁が見直しに向けた提言を策定。	<政府活動>,<日本>,<法整備・規制>,<検討>
経済産業省所管の石油天然ガス・金属鉱物資源機構とカナダ・アルバータ州は、脱炭素に向けて環境負荷の低い燃料に関する共通基準や二酸化炭素排出量の計測ルールをつくる。	<政府活動>,<カナダ>,<その他>
米政府は18日、今冬の家庭の暖房費を支援するため、45億ドルを追加で拠出すると表明した。	<政府活動>,<米国>,<補助金・交付金>
配達員の給与などの待遇改善を政府が求めていることが影響したとみられる。	
17日に欧州連合で新薬承認を判断する欧州医薬品庁の評価委員会が承認に否定的な見解を示した。	<政府活動>,<欧州>,<法整備・規制>,<検討>,<施行>
2022年5月の大統領選を控え、フィリピン政府がインターネット通販大手に警戒の目を向けている。	<政府活動>,<フィリピン>,<目標・計画・指針>
エーザイと米バイオジェンは17日、共同開発したアルツハイマー病新薬「アデュヘルム」について、欧州連合での新薬認可を判断する欧州医薬品庁の評価委員会から販売承認に否定的な見解を受領したと発表した。	<政府活動>,<米国>,<法整備・規制>
資源エネルギー庁は17日、レギュラーガソリンの店頭価格が1リットル168.9円だったと発表した。	<政府活動>,<日本>,<指数・統計>
資源エネルギー庁が17日発表した北海道内の灯油配達価格は1缶2031円と、2008年10月以来13年ぶりに2000円を超えた。	<政府活動>,<日本>,<指数・統計>
政府は原油高を受けてガソリン価格を抑える新たな対策を導入すると発表した。	<政府活動>,<日本>,<法整備・規制>,<施行>
英政府は16日、米半導体大手エヌビディアによる英半導体設計大手アームの買収について追加調査をすると発表した。	<政府活動>,<英国>,<その他>
400億ドルの大型買収が英国の競争環境や安全保障に与える影響について、競争・市場庁が本格的に調べる。	<政府活動>,<日本>,<その他>
農林水産省が16日発表した食品価格動向調査によると、11月8日の週の野菜小売価格は、調査対象の8品目のうちバレイショやタマネギなど5品目が前週比で値上がりした。	<政府活動>,<日本>,<指数・統計>
農林水産省が16日発表した2021年産米の10月のJAグループなどとコメ卸業者との相対取引価格は、1俵あたりの全銘柄平均で1万3120円と、前年同月に比べ13%下がった。	<政府活動>,<日本>,<指数・統計>
政府はガソリンなどの価格高騰を抑える新たな対策を導入する。	<政府活動>,<日本>,<法整備・規制>,<施行>
現行品の4世代先にあたり演算能力や省エネ性能が大幅に高まる。	
政府は6月、一定の条件を満たした電気をふるさと納税の返礼品として取り扱うことを認めた。	<政府活動>,<日本>,<法整備・規制>
格付投資情報センターは12日、高島屋の環境に配慮した事業を資金使途とする環境債の枠組みについて、国際資本市場協会や環境省が定める指針への適合を確認したと発表した。	
東京ディズニーリゾートを運営するオリエンタルランドは12日、新型コロナウイルスワクチン接種者などの行動制限を緩和する政府の「ワクチン・検査パッケージ」の技術実証を22~28日の一部の入園者を対象に実施すると発表した。	
返済が済んだことで政府は取得した株式を売却することになる。	<政府活動>,<日本>,<補助金・交付金>
環境省は妙高戸隠連山国立公園の利用拠点となる誘客施設「妙高高原ビジターセンター」の一部を先行開放した。	<政府活動>,<日本>,<その他>
政府は電動車関連の産業集積を目指しており、電気自動車をアピールするメーカーが目立った。	<企業活動背景>,<日本>,<目標・計画・指針>
政府は米製薬大手メルクが開発中の飲み薬「モルヌピラビル」について160万人分の購入を決めた。	<政府活動>,<日本>,<目標・計画・指針>
政府のネット企業への統制もあり、セールの風景も昨年までとは変化がみられる。	
米司法省は10日、障害者の利用者を差別したとしてライドシェア大手の米ウーバーテクノロジーズを提訴した。	<政府活動>,<米国>,<法整備・規制>
農林水産省は10日、日本産のメロンの米国向け輸出が可能になったと発表した。	<政府活動>,<米国>,<その他>
今回は立地自治体3首長や原子力規制庁など当局、東電の小早川智明社長も参加した。	<政府活動>,<日本>,<国際会議・会合・会談>
原料となる輸入小麦の政府売り渡し価格が引き上げられたことに加え、物流費なども上昇しているため。	
厚生労働省は優先的に審査をする見込みだ。	<政府活動>,<日本>,<法整備・規制>,<検討>
資源エネルギー庁は10日、ガソリンの店頭価格が1リットル169円だったと発表した。	<政府活動>,<日本>,<指数・統計>
政府は20年2月、新型コロナの感染拡大を受けて全国の小中高校などに休校の要請を出した。	<政府活動>,<日本>,<その他>
政府が8日に始めた新型コロナウイルスの水際対策の緩和を巡り、申請の手続きの煩雑さが利用の壁になっている。	<企業活動背景>,<日本>,<その他>
申請書や活動計画書など6つの書類が必要で、各業界を所管する省庁が事前審査する仕組みになっており、時間がかかる懸念が出ている。	
総務省は法令上の「重大な事故」に該当すると判断しており、ドコモは同日午前に原因や再発防止策をまとめた報告書を同省に提出した。	<政府活動>,<日本>,<法整備・規制>,<検討>,<施行>
農林水産省が9日発表した食品価格動向調査によると、11月1日の週の野菜小売価格は、レタスやキャベツなどが前週比で値上がりした。	<政府活動>,<日本>,<指数・統計>
日本政府は半導体の安定調達につながるとし、世界でも有数の技術力を持つTSMCの誘致に過去数年間、力を入れてきた。	<政府活動>,<日本>,<その他>
香港で中国政府の影響力が強まる中、地政学的なリスクを回避する。	
農林水産省は9日、北海道の2021年産水稲の作況指数が108になる見通しと発表した。	<政府活動>,<日本>,<その他>
国内で製造、流通、サービス業などの顧客がDXに向けたIT投資を増やしたほか、中央省庁や金融向け事業も拡大した。	<政府活動>,<日本>,<目標・計画・指針>
政府の需要喚起策「Go To、トラベル」が実施されていた前年同月を上回った。	
米商務省が半導体のサプライチェーンを把握するため企業に求めていた情報開示を巡り、8日に回答期限を迎えた。	<政府活動>,<米国>,<目標・計画・指針>
半導体が世界的に不足するなか、同省は供給網の問題点を洗い出して安定調達につなげる狙いだ。	<政府活動>,<日本>,<その他>
厚生労働省は2回接種を終えたすべての人を対象に追加接種を実施する方針を掲げた。	<政府活動>,<日本>,<法整備・規制>,<施行>
半導大手の台湾積体電路製造は8日、米政府が半導体不足の解消を理由に、世界の大手メーカーに対して在庫などの詳細な情報開示を求めた件について、同日までに米当局に自社の情報を提供したと発表した。	<企業活動背景>,<米国>,<法整備・規制>
デジタル庁が9月に発足した。	<政府活動>,<日本>,<その他>
ただし電子政府のサービス利用が進むかどうかは、その政府への信頼が重要な役割を果たすとの研究もある。	
いくら現場で奮闘しても、システムを提供する政府への信頼がなければ国民に受け入れてもらえないこともあるだろう。	
総務省が近く規制を緩和するのに合わせて実証実験を始め、早ければ2025年に事業化する。	<企業活動背景>,<日本>,<法整備・規制>
英国の医薬品・医療製品規制庁は4日、米製薬大手メルクが開発する新型コロナウイルスの飲み薬「モルヌピラビル」を世界で初めて承認した。	<政府活動>,<英国>,<法整備・規制>
厚生労働省は5日、中外製薬の抗体カクテル薬「ロナプリーブ」を新型コロナウイルスの発症予防薬として特例承認した。	<政府活動>,<日本>,<法整備・規制>
同省は「新型コロナウイルスによる感染症の予防の基本はワクチンで、抗体カクテル薬はワクチンに置き換わるものではない」としており、添付文書にも警告として記載した。	<政府活動>,<日本>,<法整備・規制>
厚生労働省は4日、新型コロナウイルスの抗体カクテル療法に使う中外製薬の「ロナプリーブ」について発症予防薬としての承認を決めた。	<政府活動>,<日本>,<法整備・規制>
政府は感染拡大の第6波に備え、病床確保や重症化予防に軸足を置いた対策の強化を検討している。	<政府活動>,<日本>,<法整備・規制>
英医薬品・医療製品規制庁は4日、米製薬大手メルクが新型コロナウイルス向けに開発した飲み薬を承認したと発表した。	<政府活動>,<英国>,<法整備・規制>
資源エネルギー庁は4日、ガソリンの店頭価格が1リットル168.7円だったと発表した。	<政府活動>,<日本>,<指数・統計>
菅義偉前首相の肝煎りだったデジタル庁が発足して約2カ月。	<政府活動>,<日本>,<その他>
発電事業者が洋上風力を稼働させるには、政府が指定する海域で実施する公募に応札し、事業者として選定される必要がある。	<企業活動背景>,<日本>,<その他>
米司法省は2日、米出版最大手ペンギン・ランダムハウスによる同業大手サイモン・アンド・シュスターの買収阻止を求めて連邦地裁に提訴した。	<政府活動>,<米国>,<法整備・規制>
日本の企業や政府は国際的なルールづくりでしばしば欧米に後れをとることがある。	
インバーターの搭載などで省エネ性能も高めた。	
日銀は2021年度の実質経済成長率見通しを引き下げ、財務省も景気判断を厳しく見積もる。	<政府活動>,<日本>,<指数・統計>
ロシア政府は1日、2050年に向けての温暖化ガス削減戦略を発表した。	<政府活動>,<ロシア>,<目標・計画・指針>
米政府が世界の半導体メーカーなどに顧客情報や在庫情報の提出を求める期限まで残り1週間となった。	<企業活動背景>,<米国>,<法整備・規制>
政府の中央防災会議作業部会がまとめた被害想定では、火山灰が原因で首都圏などのインフラにも大きな影響が出ることが示された。	<企業活動背景>,<日本>,<目標・計画・指針>
SPHには政府系のケッペル・コーポレーションも既に同様の提案をしており、競合する可能性が出てきた。	
提案したのはHPLとその関連会社が40%を、残りを政府系投資会社テマセク・ホールディングス傘下の不動産2社が出資して設立した新会社。	
中国政府は29日、データの海外への持ち出しに関する規則案を発表した。	<政府活動>,<中国>,<法整備・規制>,<施行>
地方自治体向けが好調だったほか、下期を予定していた官公庁向けの案件の売り上げ計上を前倒ししたことなどが寄与した。	
積水ハウスは28日、2023年度に販売する全ての新築分譲マンションを断熱性や省エネ性能が高いZEH仕様にすると発表した。	
政府が10月から輸入小麦の売り渡し価格を平均19%引き上げたため。	<政府活動>,<日本>,<その他>
日本政府が再生可能エネルギーの切り札としている洋上風力への技術転用に活路を見いだす。	
宇宙ごみ除去サービスのアストロスケールホールディングスは、英国宇宙庁が打ち上げた衛星2機を除去する技術研究プログラムの参加企業に選ばれた。	
英政府が2025年までに目指す既存のデブリの除去に向けた技術を開発する。	<企業活動背景>,<英国>,<その他>
経済産業省が実施した公開入札で、同省が保有する持ち分20.03%を落札した。	<企業活動背景>,<日本>,<補助金・交付金>
経済産業省は27日、二酸化炭素排出量の多い鉄鋼業界が2050年までに温暖化ガスの排出量を実質ゼロにするための工程表を策定した。	<政府活動>,<日本>,<目標・計画・指針>
日本政府も今後、同年齢層に対するワクチン接種の可否について審査に入る見込みだ。	<政府活動>,<日本>,<法整備・規制>,<検討>
資源エネルギー庁が27日発表した調査によると、ガソリンの店頭価格が1リットル167.3円、灯油は同114.7円だった。	<政府活動>,<日本>,<指数・統計>
運輸省傘下のトンネル公社と独シーメンスの鉄道システム事業子会社などが9月、紅海と地中海を結ぶ全長660キロメートルの高速鉄道を建設する契約を結んだ。	<政府活動>,<ドイツ>,<その他>
ロケット打ち上げはスタートラインに立ったばかりだが、韓国政府も商用化を後押ししており、「官需」で蓄積した技術を活用する。	<政府活動>,<韓国>,<目標・計画・指針>
世界的な脱炭素の流れを受け、家電や産業機器向けに省エネ型モーターが好調に推移しているため。	
世界的な脱炭素の流れを受け、家電や産業機器向けに省エネ型モーターが好調に推移しているため。	
中小企業庁が8月から申請を受けており、全国では2278件になった。	<政府活動>,<日本>,<指数・統計>
中国の新疆ウイグル自治区を供給網に持つ企業に、各国政府が規制を強めたのが代表例だ。	<企業活動背景>,<日本>,<法整備・規制>
政府機関や企業向けデータセンターやクラウドサービスの拡大も業績を押し上げた。	
インドネシア投資省は24日、台湾の鴻海精密工業が電気自動車とEV電池の工場建設を検討していると発表した。	<政府活動>,<インドネシア>,<法整備・規制>,<検討>
住宅に財産の大半をつぎ込む市民は多く、中国政府は建設計画が宙に浮くことを強く警戒している。	<政府活動>,<中国>,<その他>
原料となる輸入小麦の政府売り渡し価格が引き上げられたことに加え、人件費や包装費なども上昇しているため。	
財務省の矢野康治次官が月刊誌「文芸春秋」に寄稿した「財務次官、モノ申す、「このままでは国家財政は破綻する」」が多方面で議論を巻き起こしている。	
政府は「成長と分配の好循環」の具体策を議論する「新しい資本主義実現会議」の初会合を月内にも開く。	<政府活動>,<日本>,<国際会議・会合・会談>
政府は22日、新たなエネルギー基本計画を閣議決定した。	<政府活動>,<日本>,<法整備・規制>,<施行>
日本政府は海外勢の工場誘致に活路を求めて補助金の制度づくりに動く。	<政府活動>,<日本>,<法整備・規制>
中国景気は足元で減速懸念も強まっているが、工場の省人化需要が業績を支えるとみている。	
米半導体大手マイクロン・テクノロジーは21日、工場増強などの投資について日本をはじめとした各国政府などと協議をしていると明らかにした。	
韓国政府は2022年5月にも2号機を打ち上げる予定で、失敗の原因究明と改善策を急ぐ。	<政府活動>,<韓国>,<目標・計画・指針>
新型コロナウイルス対策の行動制限を一定の条件下で緩和する政府の「ワクチン・検査パッケージ」の実証実験が21日、京都府内の日本料理店23店舗で始まった。	<政府活動>,<日本>,<法整備・規制>
経済産業省は21日、この冬に需要が高まる液化天然ガスの確保に向けて初めての官民連絡会議を開いた。	<政府活動>,<日本>,<国際会議・会合・会談>
新型コロナウイルス対策の行動制限を一定の条件下で緩和する政府の「ワクチン・検査パッケージ」について、大阪府がミナミの繁華街で25~29日に実証実験を行う方針であることが20日、分かった。	<企業活動背景>,<日本>,<法整備・規制>
特許庁がまとめた報告書をもとに開発状況などを探った。	<企業活動背景>,<日本>,<法整備・規制>
格付投資情報センターが評価し、環境省が定める指針に適合することを確認した。	<企業活動背景>,<日本>,<法整備・規制>
経済産業省は今冬に電力やガスを安定供給できるよう液化天然ガスの確保策を強化する。	<政府活動>,<日本>,<法整備・規制>
政府が輸入小麦の売り渡し価格を引き上げたことに対応する。	<政府活動>,<日本>,<指数・統計>
英国の競争当局である競争・市場庁は20日、米フェイスブックに総額5050万ポンドの制裁金を課すと発表した。	<政府活動>,<日本>,<法整備・規制>
アリババに対する政府の圧力が和らぎつつあるとの見方も出ている。	
資源エネルギー庁は20日、18日時点のレギュラーガソリンの店頭価格が1リットル164.6円になったと発表した。	<政府活動>,<日本>,<指数・統計>
経済産業省は30年に国内のIT人材が79万人不足すると推測する。	<政府活動>,<日本>,<その他>
北米やアジアなどの年金基金や政府系ファンドなどが参加し、国内で新たに開発する物流施設に投資する。	
経済産業省は2027年度に家庭用空調の省エネルギー性能目標を引き上げる方針を決め、あるメーカーからは「確かな開発機能を持つ企業として環境規制強化は歓迎だ」との声が上がった。	<政府活動>,<日本>,<指数・統計>
政府は完全在宅勤務など厳格な行動制限を徐々に解除し、数カ月の巣ごもり生活を強いられた国民は「リベンジ」の観光を楽しんでいる。	<企業活動背景>,<日本>,<法整備・規制>,<廃止>
農林水産省が19日発表した食品価格動向調査によると、10月11日の週は調査対象の8品目のうち、レタスやキャベツなど7品目の小売価格が前週比で1~27%下がった。	<政府活動>,<日本>,<指数・統計>
経済産業省は18日、家庭用エアコンの省エネルギー性能の目標を2027年度に引き上げる方針を決めた。	<政府活動>,<日本>,<目標・計画・指針>
北海道は18日、政府が新型コロナウイルス対策の行動制限を一定の条件下で緩和する実証実験を札幌市内の飲食店やライブハウス、劇場の4施設で始めると発表した。	<政府活動>,<日本>,<法整備・規制>
1兆円規模の投資計画に対し、政府も支援を明らかにしている。	<政府活動>,<日本>,<その他>
米商務省が15日発表した9月の小売売上高は6254億ドルで前月から0.7%増えた。	<政府活動>,<米国>,<指数・統計>
前橋市は15日、先端技術で地域を活性化する政府の「スーパーシティ」構想で、地区指定獲得を目指して内閣府へ再提案した。	
政府が10月に輸入小麦の売り渡し価格を平均19%引き上げたことに対応した。	<政府活動>,<日本>,<指数・統計>
日本政府は投資額の最大半額ほどを補助金で支援する。	<政府活動>,<日本>,<補助金・交付金>
米司法省は14日、テキサスの連邦大陪審が米ボーイングの元幹部を米連邦航空局から小型機「737MAX」の情報を隠蔽した罪で起訴した、と発表した。	<政府活動>,<米国>,<法整備・規制>
総務省が報告を求める「重大な事故」にあたる可能性もある。	<企業活動背景>,<日本>,<法整備・規制>
半導体不足が長期化するなか、日本政府は経済安全保障上の観点から、有力企業の工場が国内に必要との立場だ。	<政府活動>,<日本>,<その他>
政府が目指すカジノ法改正で締め付けが強まるとの見方から、金沙中国やMGM中国といった運営会社の株価が急落した。	<企業活動背景>,<中国>,<その他>
世界の電力消費の半分を占めるモーターの省エネ技術の開発が国内外で進んでいる。	
観光資源を通じて域内連携を促す観光庁の実証事業に採択された。	
米農務省が同日発表した穀物の需給報告で、米国の2021~22年度の生産量見通しが前年度比6%増の3億8100万トンと前月発表を上回った。	<政府活動>,<米国>,<指数・統計>
政府は洋上風力の発電出力を40年に最大4500万キロワットと、20年の約770倍に引き上げる目標を立てる。	<政府活動>,<日本>,<目標・計画・指針>
資源エネルギー庁は13日、11日時点のレギュラーガソリンが1リットル162.1円になったと発表した。	<政府活動>,<日本>,<指数・統計>
政府肝煎りの「国産EV」も22年中の発売を目指す。	
米労働省が12日発表した8月の雇用動態調査によると、非農業部門の求人件数は1043万9000件と過去最高だった前月から65万9000件減った。	<政府活動>,<米国>,<指数・統計>
中国政府が掲げる2025年に半導体自給率70%の目標達成が難しい情勢になっている。	<政府活動>,<中国>,<指数・統計>
京都大学発スタートアップの京都フュージョニアリングは、英原子力エネルギー庁が2025年に着工する核融合炉の建設に参画する。	
国連の「気候変動に関する政府間パネル」が地球温暖化をシミュレーションする際に利用された。	
自宅で服用が可能なため、医療機関の負担が軽くなると期待されており、米国で緊急使用許可が出れば、日本政府も国内審査を経て年内にも承認する方針を示している。	<政府活動>,<日本>,<法整備・規制>
ベトナム運輸省が国内線の特定ルートで運航の再開を認めたことで、ベトナム航空や格安航空会社最大手のベトジェットエア、新興のバンブー航空などが具体的な運航便を発表した。	<企業活動背景>,<ベトナム>,<法整備・規制>
安価な運搬方法が確立されれば水素利用の拡大につながり、2050年に温暖化ガス排出量を実質ゼロにする政府目標の実現に役立つ。	
地熱産業の輸出を柱に据える政府の脱炭素戦略にも影響を与えそうだ。	
総投資額は8000億円規模とされ、日本政府が最大で半分程度を補助する見通し。	<政府活動>,<日本>,<補助金・交付金>
日本政府が海外企業に巨額の支援をするのは異例のことで今後、曲折も予想される。	<政府活動>,<日本>,<補助金・交付金>
インド政府は8日、業績不振が続く国営エア・インディアの全株式を同国最大財閥のタタ・グループに売却すると発表した。	<政府活動>,<インド>,<補助金・交付金>
政府はかねて売却先を募り、タタが最有力候補だと報じられていた。	<政府活動>,<日本>,<補助金・交付金>
総投資額は8000億円規模で、日本政府が最大で半分を補助する見通し。	<政府活動>,<日本>,<補助金・交付金>
経済産業省は8日、2021年10~12月期の国内粗鋼生産量が前年同期比9.6%増の2411万トンになるとの見通しを発表した。	<政府活動>,<日本>,<指数・統計>
宅配や省人化など次世代モデルの構築が急務となっている。	
厚労省は12月にも追加接種を始めたい考えで、データを基に審査する。	<政府活動>,<日本>,<法整備・規制>,<検討>
政府は追加接種をにらみ、ファイザーと1億2000万回分のワクチン供給に向けて協議をしている。	<政府活動>,<日本>,<法整備・規制>,<検討>
背景には総務省の接待問題もある。	
配達や持ち帰りに限っていた政府の外食促進策「Go To、イート」は店内での飲食にも使えるようにする。	
政府が低炭素化政策を打ち出し、国内天然ガス田の枯渇も迫るなど逆風が吹く中、液化天然ガス輸入や発電、自然エネルギー導入推進に海外勢のノウハウを活用する。	<企業活動背景>,<日本>,<目標・計画・指針>
省エネや、自社で再生可能エネルギーを利用した発電に取り組み、50年度にはグループから排出するCO2を実質ゼロにする目標を加えた。	
融資に政府保証が付くのは今回が初めてとみられる。	
政府が新型コロナウイルス禍で資金不足に陥った企業を支援するために設立した保証制度を使う。	<企業活動背景>,<日本>,<目標・計画・指針>
厚生労働省は毎年9月以降、全国約5000カ所の医療機関の患者数を取りまとめて発表する。	<政府活動>,<日本>,<その他>
北欧ノルウェーで政府や企業が交通インフラを「脱炭素仕様」に塗り替えようとしている。	<政府活動>,<ノルウェー>,<その他>
政府は2050年までに温暖化ガス排出の実質ゼロを目標に掲げた。	<政府活動>,<日本>,<目標・計画・指針>
アラブ首長国連邦アブダビの政府系ファンドが出資する半導体受託製造大手グローバルファウンドリーズは6日までに、ナスダック市場への新規株式公開を申請した。	
金融庁は上場企業など約4000社を対象に、気候変動に伴う業績などへの影響を開示するよう義務付けることを検討する。	<政府活動>,<日本>,<法整備・規制>,<検討>
欧州連合で医薬品の審査を担当する欧州医薬品庁は4日、新型コロナウイルスワクチンの追加接種について、健康な18歳以上も2回目の接種から6カ月後に接種してもよいと勧告した。	<政府活動>,<欧州>,<法整備・規制>
石油由来の従来のジェット燃料から、バイオ原料などを使った持続可能な航空燃料への切り替えを加速し、エネルギー業界や各国政府との連携も模索する。	
農林水産省は2021年度第2次の小豆の関税割当数量を1万3400トンにする。	<政府活動>,<日本>,<税制・予算>
人手不足が続く建設業では2024年度から残業規制が導入されるため、デジタル技術の導入による省力化が急務になっている。	
英政府が温暖化ガスの削減に向けた施策として、ガス料金に上乗せする環境課税の強化を検討していることが明らかになった。	<政府活動>,<英国>,<税制・予算>
政府は電子商取引サイトに出品した個人事業者が買い手に名前や連絡先などの個人情報を開示しなくても取引できるようにする。	<政府活動>,<日本>,<その他>
消費者庁がこのほどインターネット上の商品取引のルールなどを定めた特定商取引法の運用を整理し直した。	<政府活動>,<日本>,<法整備・規制>,<検討>
政府がリチウムの採掘を独占するほか、電力市場で国営企業を優遇する措置を導入する。	<政府活動>,<日本>,<法整備・規制>,<施行>
リチウムなど戦略的に重視する鉱物の採掘を政府が独占する。	<政府活動>,<日本>,<その他>
温暖化対策の国際枠組みである「パリ協定」の実現に向け、各国の代表や非政府組織らが脱炭素の目標や、その具体策を話し合う。	
気候変動に関する政府間パネルが8月に公表した報告書の分析も使いながら、脱炭素の対策を加速する背景や、COP26の焦点、課題を読み解く。	<企業活動背景>,<日本>,<目標・計画・指針>
経済産業省は1日、脱炭素技術の研究開発や普及を支援する2兆円の基金から次世代半導体などデジタルインフラ事業に最大1410億円を拠出する方針を決めた。	<政府活動>,<日本>,<目標・計画・指針>
農林水産省は1日、2021年度のバター輸入枠を6400トンから9500トンに見直すと発表した。	<政府活動>,<日本>,<法整備・規制>,<検討>,<改正>
バターや脱脂粉乳は農水省が輸入量や価格水準を管理する「国家貿易」の下にある。	
対象は、鉄道やバス、航空などを組み込んだツアーや宿泊商品を念頭に観光庁が選ぶ。	<政府活動>,<日本>,<目標・計画・指針>
2030年に300万トンのアンモニア燃料の調達をめざす日本政府の目標にメドがつく。	
総務省は10月以降に発売する携帯端末で、自社回線でしか使えないようにするSIMロックを原則禁止。	<政府活動>,<日本>,<法整備・規制>
南部の広東省では1日、気温上昇で需要が高まる特別ピーク時の料金を25%上げる。	
上海に近い浙江省も10月中旬、ピーク時の料金を引き上げる。	
経済産業省が30日発表した8月の商業動態統計速報によると、小売業販売額は前年同月比3.2%減の12兆180億円だった。	<政府活動>,<日本>,<指数・統計>
日本政府が掲げた高い目標の達成に向け、経済産業省資源エネルギー庁の政策立案力や調整力が問われている。	<企業活動背景>,<日本>,<目標・計画・指針>
同庁は1973年のオイルショックを受けて設立され、価格が高騰する石油の消費を抑えようと省エネ政策を主導した。	<政府活動>,<日本>,<その他>
経済産業省が30日発表した8月の鉱工業生産指数速報値は95.0となり、前月比3.2%下がった。	<政府活動>,<日本>,<指数・統計>
農林水産省が29日に公表した10月の野菜卸値見通しによると、調査対象の14品目のうちバレイショとタマネギは1カ月を通して平年より2割以上高値になりそうだ。	<政府活動>,<日本>,<指数・統計>
資源エネルギー庁が29日発表した27日時点のガソリン給油所の全国平均販売価格は、前週比0.3円高い1リットル158.7円。	<政府活動>,<日本>,<指数・統計>
国土交通省は7月に不正が発覚したトヨタモビリティ東京の店舗「レクサス高輪」について、車を国の車検場に持ち込まず車検サービスを店で完結できる認証の「指定自動車整備事業」を取り消す処分をした。	<政府活動>,<日本>,<法整備・規制>
企業が知的財産の投資・活用を通じて成長する「知財ガバナンス」を進めるのを促すため、政府がガイドライン作りに乗り出した。	<政府活動>,<日本>,<その他>
政府はJR北海道が分割民営化時に赤字補填のために配分された「経営安定基金」のうち約3000億円を高金利で貸し付けられるようにし、新型コロナウイルス禍で悪化する同社の経営を支援する。	<政府活動>,<日本>,<補助金・交付金>
総務省幹部への接待問題が発覚後、官僚らとの個別の会食を原則、禁止する決まりを設けた。	
住友不動産は28日、断熱性や省エネ性能が高い「ZEH-M」を新築分譲マンションの標準仕様にすると発表した。	
政府が28日に発表する北海道を含む19都道府県の緊急事態宣言について、北海道でも10月から解除される可能性が浮上している。	<企業活動背景>,<日本>,<法整備・規制>,<廃止>
自社技術を利用し、50年に温暖化ガス排出量を実質ゼロとする政府目標より早期の実現を目指す。	
ローカル5Gは総務省が電波を開放し、工場など地域を限定して通信網を整備できる。	<政府活動>,<日本>,<その他>
22年3月までにイベント開催制限が完全に撤廃され、政府の支援が25年まで継続することを前提にしている。	
経済産業省と国土交通省は洋上風力整備の「促進区域」として新たに秋田県沖を選んだが、北海道は促進区域選定につながる「有望区域」への格上げもゼロ。	<政府活動>,<日本>,<目標・計画・指針>
経済産業省は太陽光の発電量が多くて電気が余りがちな昼間に安く、需給が厳しい時に高くなるプランの設定を事業者に義務付ける検討に入った。	<政府活動>,<日本>,<法整備・規制>,<検討>
政府が検討する新型コロナウイルスのワクチン接種者を対象にした行動制限の緩和に期待が集まる。	<企業活動背景>,<日本>,<その他>
国土交通省は26日、JR東海によるリニア中央新幹線の静岡工区のトンネル掘削工事の影響を議論する有識者会議を開いた。	<政府活動>,<日本>,<国際会議・会合・会談>
国交省は26日に同報告の修正案を示し、不測の事態が起これば工事を一時中断して河川や地下水への影響を確認するなど、JR東海が監視を徹底すると盛り込んだ。	<政府活動>,<日本>,<法整備・規制>,<改正>
中国政府が主催する世界インターネット大会が26日に開幕した。	<企業活動背景>,<中国>,<その他>
電子政府の司令塔の役割を果たす韓国知能情報社会振興院の文龍植院長は「電子政府成功のカギは業務プロセスの革新にある」と語った。	
--韓国で電子政府が進んだ背景は。	
八丁味噌の登録では、農水省は2017年12月、愛知県全体を生産地とし、近代的な製法で生産する業者も加盟する組合の製品を保護対象に認定した。	<政府活動>,<日本>,<法整備・規制>
資源エネルギー庁が24日発表した21日時点のガソリン給油所の全国平均販売価格は1リットル158.4円。	<政府活動>,<日本>,<指数・統計>
化学肥料に比べて市場規模は小さいが、農林水産省が5月に有機農業面積の大幅拡大を盛り込んだロードマップを策定したことを受けて問い合わせが増えている。	<政府活動>,<日本>,<指数・統計>
温暖化ガス排出量を2050年に実質ゼロにする政府目標の達成に向け、早期の技術開発を目指す。	
エネルギー商社の鈴与商事は22日、甲府支店の新社屋が国の推進する省エネルギービルの認証「ニアリーZEB」を取得したと発表した。	
政府は若手支援に力を入れ始めたが、非常に先駆的でユニークな取り組みが京都大学にある。	<企業活動背景>,<日本>,<その他>
米司法省は21日、米アメリカン航空と米格安航空会社大手ジェットブルー航空の提携が反トラスト法に違反するとして、提携阻止を求めて東部マサチューセッツ州の裁判所に提訴した。	<政府活動>,<米国>,<法整備・規制>
9月にデジタル庁が発足し、国を挙げた行政のデジタル化が動き出した。	<企業活動背景>,<日本>,<その他>
タイ政府が国営タイ石油公社を通じ、国内の電気自動車の普及を一気に進める。	<政府活動>,<タイ>,<目標・計画・指針>
中国政府は観光需要をテコに、弱含む景気の復調につなげる。	<政府活動>,<中国>,<その他>
仕入れ価格の上昇で販売価格との「逆ざや」が急速に広がったためで、英政府は関係機関と対応協議を続ける。	<政府活動>,<英国>,<法整備・規制>,<検討>
ロイター通信は19日、異常破裂によって複数の死亡事故を起こした旧タカタ製のエアバッグについて、米運輸省高速道路交通安全局が安全性に関する追加調査を行うと報じた。	<政府活動>,<米国>,<法整備・規制>,<改正>
総務省は20日の敬老の日にあわせ、65歳以上の高齢者に関する統計を公表した。	<政府活動>,<日本>,<その他>
政府が秋にも行動制限を緩和する見通しを受け、新型コロナウイルス禍の外出自粛要請などで打撃を受けてきた旅行・外食各社が準備に動き出した。	<企業活動背景>,<日本>,<法整備・規制>
経済産業省などが実施する、スタートアップ側から評価されている大企業についての調査で、KDDIが4年連続で首位になった。	<政府活動>,<日本>,<指数・統計>
調査は「イノベーティブ大企業ランキング」として、スタートアップと大企業を結ぶイベント「イノベーションリーダーズサミット」運営事務局と経産省が共同で実施。	<政府活動>,<日本>,<その他>
農林水産省が17日発表した2020年産米の8月分の相対取引価格は1俵あたりの全銘柄平均で1万3830円と、前年同月に比べ11%下がった。	<政府活動>,<日本>,<指数・統計>
北海道は新型コロナウイルス対策で政府が検討している行動制限緩和に向けた実証実験に参加する意向を17日中に伝える。	<政府活動>,<日本>,<その他>
厚生労働省は17日、専門家会議を開き、遺伝子を効率よく改変するゲノム編集技術を使って品種改良したマダイについて、安全審査を不要と判断した。	<政府活動>,<日本>,<法整備・規制>,<検討>
米商務省が発表した8月の小売売上高は6187億ドルで前月から0.7%増えた。	<政府活動>,<米国>,<指数・統計>
フィリピン財務省は16日、SNSで人気があり影響力を持つ「インフルエンサー」と呼ばれる人物250人を対象に、納税義務を果たしているか調査に乗り出すと発表した。	<政府活動>,<フィリピン>,<税制・予算>
徴税を担う内国歳入庁が調査を進める。	<政府活動>,<日本>,<法整備・規制>
米政府は20日に追加接種を始める計画を立てており、FDAなどが専門家による検討を進めている。	<企業活動背景>,<米国>,<法整備・規制>,<検討>
米商務省が16日発表した8月の小売売上高は6187億ドルで前月から0.7%増えた。	<政府活動>,<米国>,<指数・統計>
特許庁が4月に公表した出願動向調査「半導体露光の前後処理技術」をもとに、露光周辺技術の動向をまとめた。	<政府活動>,<日本>,<その他>
資源エネルギー庁が15日発表した13日時点の全国平均は1リットル158.3円と前週比0.2円高い。	<政府活動>,<日本>,<指数・統計>
総務省は2021年度から産学官連携で人工衛星の故障を予防するサービス開発に乗り出す。	<政府活動>,<日本>,<その他>
政府が目指す脱炭素やエネルギー政策の議論で避けて通れない。	<企業活動背景>,<日本>,<その他>
東京電力福島第1原子力発電所から出る放射性物質を含む処理水の海洋放出を巡り、関係省庁と東京電力によるリモート説明会が14日、茨城県や市町村、関係団体向けに開かれた。	<政府活動>,<日本>,<国際会議・会合・会談>
経済産業省などが風評被害の抑制や賠償を含む当面の対策を説明する一方、漁業団体からは放出反対の声が上がった。	<企業活動背景>,<日本>,<指数・統計>
政府が処理水放出に関する当面の対策をとりまとめた8月下旬以降、茨城の関係者への説明は初めて。	
政府などはテレワークによる出勤者数の7割削減を求めているが、対応に苦慮している現状が改めて浮き彫りになった。	<企業活動背景>,<日本>,<法整備・規制>
米農務省は10日発表した穀物の需給報告で、2021~22年度の米国の大豆生産量見通しを前年度比6%増の1億1900万トンと前月発表に比べ上方修正した。	<政府活動>,<米国>,<指数・統計>,<改正>
格差是正にむけ政府が掲げる「共同富裕」も人件費増など業績への重荷となる。	<企業活動背景>,<日本>,<その他>
経済産業省は13日、脱炭素化を支援する2兆円の基金から、二酸化炭素を資源として再利用する技術の普及に最大1830億円を配分する方針を決めた。	<政府活動>,<日本>,<目標・計画・指針>
経済産業省と国土交通省は13日、洋上風力発電の整備を促進する区域として新たに秋田県八峰町と能代市沖の3200ヘクタールを指定した。	<政府活動>,<日本>,<目標・計画・指針>
8月には9月末までとしていたが、鉄道の利用状況が引き続き厳しく、政府の雇用調整助成金の特例措置の期限が11月末までのため、さらに2カ月間延長する。	
政府は2040年までに最大で4500万キロワットの洋上風力発電の案件をつくる目標を掲げており、日本での洋上風車の需要増を見込む。	<企業活動背景>,<日本>,<目標・計画・指針>
各国政府が「脱炭素」の政策を競うなか、脱炭素への姿勢を鮮明にして巨大市場を取り込む。	<企業活動背景>,<日本>,<その他>
環境省と経済産業省は、企業の温暖化ガス排出量の報告内容や公表の手法を見直す。	<政府活動>,<日本>,<法整備・規制>,<検討>,<改正>
政府が配布した30ドル相当のビットコインを現金化しようと並んでいたが、ATMが故障したのだ。	
政府は新型コロナウイルス対策の緊急事態宣言に関し、宮城、岡山の両県を13日から解除する。	<政府活動>,<日本>,<法整備・規制>,<廃止>
総務省は10日、携帯販売代理店の不適切営業についての通報窓口を設置したと発表した。	<政府活動>,<日本>,<その他>
2020年12月以降に日本に入国・帰国した陽性者のゲノム解析結果を厚労省が集計して判明した。	<政府活動>,<日本>,<その他>
日本の農林水産省は2021年5月に「みどりの食料システム戦略」を公表し、日本の農林水産業が目指す将来像を示した。	<政府活動>,<日本>,<目標・計画・指針>
香港紙サウスチャイナ・モーニング・ポストは9日、中国政府がネットゲームの新作発売に関する審査を一時凍結したと報じた。	<政府活動>,<チャイナ>,<法整備・規制>,<廃止>
中国政府は直近、未成年者のゲーム利用を厳しく制限するなど業界への締め付けを強めている。	<政府活動>,<中国>,<目標・計画・指針>
企業は規制に先回りすることが必要になり、政府への協力も重要な責任と強調した。	
スミス氏はマイクロソフトで法務畑を歩み、1990年代後半から2000年代前半にかけて米司法省が同社を反トラスト法違反の疑いで訴えた裁判を担当した。	
政府は12日までとしていた緊急事態宣言を19都道府県で30日まで延長した。	<政府活動>,<日本>,<法整備・規制>,<改正>
経済産業省などが主催しており、ファナックや安川電機など40弱の企業や自治体も参加。	<政府活動>,<日本>,<国際会議・会合・会談>
米労働省が8日発表した7月の雇用動態調査によると、非農業部門の求人件数は1093万4000件で前月から74万9000件増加した。	<政府活動>,<米国>,<指数・統計>
政府が掲げた2050年までに国内の温暖化ガス排出実質ゼロ、30年度に13年度比で46%削減する目標に向けた原子力発電と再生可能エネルギーのあり方が論戦の主戦場になる。	<企業活動背景>,<日本>,<目標・計画・指針>
英国の競争・市場庁は7日、米ソニー・ミュージックエンタテインメントによる音楽配信の支援サービス「AWAL」の買収について、「競争上懸念がある」と発表した。	<政府活動>,<英国>,<補助金・交付金>
資源エネルギー庁が8日発表した6日時点の全国平均は1リットル158.1円と、前週比0.3円高い。	<政府活動>,<日本>,<指数・統計>
農林水産省は8日、国が輸入して製粉会社などに売り渡す小麦の価格を10月から前半期に比べ平均19%引き上げると発表した。	<政府活動>,<日本>,<指数・統計>
2050年までに二酸化炭素排出量を実質ゼロにする「カーボンニュートラル」を政府が発表し、脱炭素化に向けた動きが自動車業界にも大きく広がっている。	<企業活動背景>,<日本>,<その他>
厚生労働省は7日、国内で4番目となる新型コロナウイルスワクチンの供給にめどがついたと発表した。	<政府活動>,<日本>,<その他>
農林水産省が7日発表した食品価格動向調査によると、8月30日の週はレタスとキュウリの小売価格が平年比で約6割高となった。	<政府活動>,<日本>,<指数・統計>
3例目の死亡例の発生については、既に厚労省が6日に発表。	<政府活動>,<日本>,<その他>
情報通信研究機構などは無線基地局を簡素化し、大幅な省エネと低コスト化を可能にする技術を共同開発した。	
再生可能エネルギーの調達や省エネ機器の導入も後押しする。	
日本のデジタル政策の司令塔となるデジタル庁が1日から始動した。	<政府活動>,<日本>,<その他>
米政府は製油所の円滑な再開に向け、戦略石油備蓄を放出し、米石油大手エクソンモービルに150万バレルを貸し出すと発表した。	<政府活動>,<米国>,<その他>
国土交通省の審議会が7月、完全民営化や新線の早期実現を求める答申をまとめたことに応じたもの。	<企業活動背景>,<日本>,<法整備・規制>
格付投資情報センターは3日、東急不動産ホールディングスが発行予定のESG債について環境省が定める指針に適合することを確認したと発表した。	<企業活動背景>,<日本>,<法整備・規制>
2021年度では同省が選ぶグリーンファイナンスで初めてのモデル事例となる。	<企業活動背景>,<日本>,<その他>
高速通信規格「5G」の対応などでスマホの消費電力が増えるなか、ニーズの高まる省エネ電子部品のシェアの拡大を目指す。	
三省堂書店は2日、東京都千代田区神田神保町にある本社・本店ビルを建て替えると発表した。	<政府活動>,<日本>,<その他>
厚生労働省は優先して審査を進める「先駆的医薬品」に同候補薬を国内で初めて指定している。	<政府活動>,<日本>,<目標・計画・指針>
新型コロナウイルス禍で来日に支障が出ているが、政府も外国人技能実習制度や特定技能制度で受け入れを進める。	<政府活動>,<日本>,<目標・計画・指針>
厚生労働省は8月26日、異物混入が報告されたロットと、同時期に同じ生産ラインで作られた2つのロット番号のワクチン約160万回分の接種を見合わせるよう要請。	<政府活動>,<日本>,<法整備・規制>
資源エネルギー庁が1日発表した8月30日時点の全国平均は1リットル157.8円と、前週比0.4円安い。	<政府活動>,<日本>,<指数・統計>
風邪の症状や喉の痛みを和らげる効果があるとしてタイで古くから用いられてきた植物だが、タイ政府が新型コロナウイルスの軽症患者の症状を和らげるとし、栽培を推奨しているためだ。	
背景には農家の所得を増やし、ワクチン調達の遅れや経済低迷への不満を抑え込みたい政府の思惑がある。	
厚生労働省が定める「職業性ストレス簡易調査票」の57項目の質問と、独自に設定した質問で構成する。	
中国政府は大型テーマパークの運営を認可し、新型コロナウイルスの感染を抑え込みながら、消費振興の両立をめざす。	<政府活動>,<中国>,<法整備・規制>
HPVワクチンは2013年4月に公的な定期接種の対象になったが、全身の痛みなど副反応の報告が相次いだことから、厚労省は同年6月に積極的な接種の勧奨を中止していた。	<政府活動>,<日本>,<法整備・規制>,<廃止>
政府が2019年に定めた「AI戦略」で人材育成を打ち出したのを受け、デジタル社会の担い手の裾野を広げるのが狙いだ。	<企業活動背景>,<日本>,<目標・計画・指針>
調達する資金は自然災害対策やホームドア整備、省エネルギー性能が高い新型車両の導入などの費用の一部に充てる。	
音の商標は2015年に導入され、マツキヨは17年に出願したが、特許庁側は、電話帳「ハローページ」に「マツモトキヨシ」と読む別人が複数掲載されていることなどから、商標登録はできないとしていた。	<政府活動>,<日本>,<法整備・規制>
デジタル庁は首相の下にデジタル相を据える首相直轄の組織だ。	
シンガポール政府はネットを介して単発の仕事を請け負う「ギグワーカー」の保護策を導入する。	<政府活動>,<シンガポール>,<その他>
政府は27日、製鉄所やコンビナートにおけるドローン利用の規制緩和を公表した。	<政府活動>,<日本>,<法整備・規制>
政府は2021年度中にもロボットの公道での走行を認める方針で、物流企業は配送の効率化のためにロボット導入を目指す。	<政府活動>,<日本>,<法整備・規制>
山梨・静岡両県のアクセスが向上し、両県庁間は1時間35分と一般道を利用した場合より70分短くなる。	
文部科学省の研究所が8月上旬にまとめた報告書では、科学論文の影響力や評価を示す指標でインドに抜かれて世界10位に落ちた。	<政府活動>,<日本>,<指数・統計>
世界の科学論文の動向は文科省の「科学技術・学術政策研究所」が毎年まとめている。	<政府活動>,<日本>,<その他>
経済産業省は27日、電力会社が保管する液化天然ガスの在庫や発電の余力を監視する方針を決めた。	<政府活動>,<日本>,<目標・計画・指針>
中国政府系機関は27日、中国のインターネットの利用者が10億人を突破したと発表した。	<政府活動>,<中国>,<指数・統計>
新薬承認の審査手続きを上部機関の米保健福祉省が調査する異例の展開となり、両社には誤算だ。	<企業活動背景>,<米国>,<その他>
現時点で健康被害は確認されていないが、厚生労働省は混入の可能性がある約160万回分の使用見合わせを要請。	<政府活動>,<日本>,<法整備・規制>
同省は異物は金属の可能性があるとみている。	<政府活動>,<日本>,<目標・計画・指針>
神奈川県や横浜市による支援もあり、企業は2050年までに実質ゼロにする政府目標に向けた取り組みを加速させている。	<企業活動背景>,<日本>,<目標・計画・指針>
カルチュア・コンビニエンス・クラブ傘下のCCCマーケティングは26日、福島県会津若松市で進む政府の「スーパーシティ」構想に参加すると発表した。	
厚生労働省は日本時間26日未明、複数の接種施設から異物の混入が報告されたとして、モデルナ製ワクチン約160万回分の接種を見合わせると発表した。	<政府活動>,<日本>,<その他>
巨大ITに対しては各国政府が監視の目を強めている。	<政府活動>,<日本>,<目標・計画・指針>
政府は27日から、北海道を新型コロナウイルスの緊急事態宣言の対象に加える。	<政府活動>,<日本>,<法整備・規制>,<施行>
中国工業情報化省も25日、ナトリウムイオン電池の規格作りに乗り出すと発表。	<政府活動>,<日本>,<その他>
実現に向けたエネルギー基本計画や、炭素に価格をつけるカーボンプライシングの議論では省庁間の縦割りや不毛な綱引きばかりが目立つ。	
政府は4月、炭素ゼロの中間的目標である30年度の温暖化ガス削減を、13年度比46%減に引き上げた。	<政府活動>,<日本>,<指数・統計>
資源エネルギー庁が25日発表した23日時点の全国平均は1リットル158.2円と、前週に比べて0.4円安い。	<政府活動>,<日本>,<指数・統計>
米中対立を受けて中国政府が半導体産業の成長を後押ししたことで製造装置の販売が好調だったうえ、政府の補助金が大幅に増えた。	<政府活動>,<中国>,<指数・統計>
高止まりする通信料に政府が法改正などでメスを入れてきた結果だ。	
従来の注射によるワクチンより低コストで省力化が見込めるとしている。	
政府の分科会が12日に人流抑制に向けて百貨店に強力な措置を求めたことを受けて、新型コロナウイルス下で初めて実施した。	<企業活動背景>,<日本>,<法整備・規制>
農林水産省が発表した2021年の一番茶の作物統計によると、静岡県の荒茶生産量は前年比2.7%増の9680トンだった。	<政府活動>,<日本>,<指数・統計>
厚生労働省が原則40歳以上への公的接種の対象に加えることを決定し、滞留していたワクチンの使用メドがつき始めた。	<企業活動背景>,<日本>,<法整備・規制>,<施行>
中国政府などが主催し、例年は米国のハイテク企業の幹部の参加が目立っていた。	<企業活動背景>,<米国>,<その他>
政府の補助金が支給されるほか、新型コロナウイルス禍で出張を自粛したことなどに伴うコスト削減が寄与する。	<企業活動背景>,<日本>,<その他>
各国政府が「脱炭素」に動くなか、バスの電動化のインフラ市場を開拓する。	
ESGの動きが広がるなか、女性登用に取り組む企業は増加傾向にあるものの、政府が掲げる女性管理職比率30%の達成には遠く及ばない結果となった。	<企業活動背景>,<日本>,<その他>
過酷な状況に耐える技術を生み出すことで、一般住宅の省エネルギー化や新たなビジネスにつなげる構えだ。	
質問、政府、企業、国民がよりよい日本を目指しているのに、うまく進んでいるように思えません。	<企業活動背景>,<日本>,<目標・計画・指針>
厚生労働省などが所管する日本医療研究開発機構が、国内100以上の大学や研究機関のデータを集約する。	
国税庁は同訴訟で問題となった金融商品の税務上の取り扱いを変更した。	<政府活動>,<日本>,<税制・予算>,<改正>
英国の競争・市場庁は20日、米半導体大手エヌビディアによる英半導体設計大手アームの買収について「競争上の深刻な懸念がある」とする報告書をまとめた。	<政府活動>,<英国>,<法整備・規制>
英政府は報告書を受け、最大400億ドルの大型買収を阻止するかどうかを精査する。	<政府活動>,<英国>,<法整備・規制>,<検討>
国連の気候変動に関する政府間パネルは最新の報告書で、温暖化の元凶が人間の活動にある、と断定した。	<政府活動>,<日本>,<その他>
政府は30年度に温暖化ガスを13年度比で46%減らす目標を掲げる。	<政府活動>,<日本>,<目標・計画・指針>
消費者庁は20日、企業の不正を通報した人の保護を強化する体制について指針を公表した。	<政府活動>,<日本>,<その他>
細菌による感染症に使う抗生物質「メロペン」の依存度が高く、政府が全国の公立病院で使う医薬品を入札で決める「集中購買」の影響を受ける可能性がある。	<政府活動>,<日本>,<その他>
2050年に温暖化ガス排出量を実質ゼロにする政府目標の達成に貢献する技術として、都市ガス業界は実用化を急ぐ。	
農林水産省がまとめた2020年産米の7月分の相対取引価格は1俵あたりの全銘柄平均で1万4057円と、前年同月に比べ10%下がった。	<政府活動>,<日本>,<指数・統計>
環境省と経済産業省は18日、日本が排出する温暖化ガスを2050年までに実質ゼロにする長期戦略案をまとめた。	<政府活動>,<日本>,<目標・計画・指針>
政府は戦略を10月までに閣議決定し、国連への提出をめざす。	<政府活動>,<日本>,<法整備・規制>,<施行>
資源エネルギー庁が18日発表した16日時点の全国平均は1リットル158.6円と、前週に比べて0.1円高い。	<政府活動>,<日本>,<指数・統計>
国連の気候変動に関する政府間パネルの第1作業部会が、世界の気候変動の実情や予測に関する科学分析の結果を報告書にまとめた。	<政府活動>,<日本>,<法整備・規制>,<検討>
政府は2040年までに原発45基分を整備する方針だが、道筋は不透明だ。	<政府活動>,<日本>,<目標・計画・指針>
法廷闘争が長引けば、2024年の有人月面探査再開を目指す米政府のスケジュールにも影響する恐れがある。	
新型コロナウイルスの感染拡大を受け、国土交通省関東地方整備局は国営ひたち海浜公園を18日から臨時休園すると発表した。	<政府活動>,<日本>,<その他>
群馬県桐生市の養豚場で豚熱に感染した豚が発見された問題で、現地を調査した農林水産省はウイルスを媒介する可能性のあるネズミを豚舎で発見したとする調査概要を発表した。	<政府活動>,<日本>,<その他>
農水省の疫学調査チームが調べたところ、感染した子豚のいた豚舎などでネズミが確認された。	<企業活動背景>,<日本>,<その他>
石油元売り大手のコスモエネルギーホールディングスは17日、同社の筆頭株主であるアラブ首長国連邦アブダビ首長国の政府系ファンド、ムバダラ・インベストメントが8月10日に保有する株式の一部を売却したと発表した。	
米運輸省高速道路交通安全局は16日、米テスラの約76万5000台の電気自動車について、運転支援システムの安全性を正式に調査すると発表した。	<政府活動>,<米国>,<その他>
政府の分科会は人流を抑制するための具体策として、百貨店地下の食品売り場などへの人出を減らすよう提言した。	<政府活動>,<日本>,<目標・計画・指針>
消費者庁は2022年6月までの改正公益通報者保護法施行に向け、8月中にも企業向けの指針を公表する。	<政府活動>,<日本>,<その他>
米農務省が12日発表した8月の需給報告によると、2021~22年度の米国のトウモロコシ生産量の見通しは前年度比4%増の3億7400万トンと、前月発表に比べ下方修正した。	<政府活動>,<米国>,<指数・統計>
厚生労働省は13日、新型コロナウイルスの軽症・中等症向けの治療薬「抗体カクテル療法」を巡り、これまで入院患者への投与に限るとしていた地方自治体向けの通知を改正した。	<政府活動>,<日本>,<法整備・規制>,<改正>
政府は2021年度から、金融機関が投融資先企業の排出量を簡易に測定できるモデルづくりを始める。	<政府活動>,<日本>,<その他>
英国の競争・市場庁は12日、米フェイスブックによるGIF画像サービス大手、米ジフィーの買収に関する暫定の調査結果を発表した。	<政府活動>,<英国>,<その他>
米農務省は12日発表の8月の穀物需給で、2021~22年度の米国のトウモロコシの生産見通しを大幅に引き下げた。	<政府活動>,<米国>,<目標・計画・指針>
政府は企業の不正を通報した人の保護を強化する具体策を記した指針をまとめた。	<政府活動>,<日本>,<その他>
資源エネルギー庁が12日発表した10日時点のレギュラーガソリンの店頭価格は1リットル158.5円と前週比0.3円高い。	<政府活動>,<日本>,<指数・統計>
これまでは流通量が限られるとして厚生労働省が買い上げて医療機関に配分していた。	
政府が1億香港ドルを投じて、企業誘致や教育、就業などの支援を進める。	<政府活動>,<日本>,<目標・計画・指針>
eスポーツ競技場を整備した政府系の起業支援施設、サイバーポートの任景信・最高経営責任者に聞いた。	
小中学生に1人1台のデジタル端末を配布する政府の「GIGAスクール構想」に対応した、次世代型学習塾の設立を目指す。	
国連気候変動に関する政府間パネルが9日に公表した報告書は、人間が地球温暖化を引き起こしたことを「疑う余地がない」と断じた。	<企業活動背景>,<日本>,<その他>
7月に国土交通省が東京メトロ有楽町線の延伸など3区間について「早期整備が妥当」「事業化に向けた検討を進める」とする答申をまとめた。	<政府活動>,<日本>,<その他>
政府が25年度にも始める月面の水探査に向け、採掘などの技術や機器を共同研究する。	<企業活動背景>,<日本>,<その他>
文部科学省の研究所が10日発表した報告書では注目度の高い論文の数で初めて首位となり、研究の量だけでなく質の面でも急速に台頭していることを印象づけた。	<企業活動背景>,<日本>,<指数・統計>
中国政府が国家備蓄した綿花を売却する入札で、中国綿糸メーカーなどの買いが殺到している。	<企業活動背景>,<中国>,<その他>
自然科学分野の論文の注目度の高さを示す指標で中国が初めて世界一になったとする報告書を、文部科学省の研究所が10日公表した。	<政府活動>,<中国>,<その他>
国連の気候変動に関する政府間パネルが9日公表した報告書は、切迫する温暖化のリスクを世界につきつけた。	<企業活動背景>,<日本>,<その他>
韓国法務省は9日、サムスン電子トップの李在鎔副会長を13日に仮釈放すると発表した。	<政府活動>,<韓国>,<その他>
法務省の仮釈放審査委員会が9日に協議し、仮釈放適格と判断した。	<政府活動>,<日本>,<法整備・規制>,<検討>
経済産業省は原子力発電所の廃炉で生じる低レベルの放射性廃棄物の一部を国外で処分できるようにする方針だ。	<政府活動>,<日本>,<法整備・規制>
ビジネス街の丸の内や官庁が集中する霞が関にも近い東京・内幸町の街づくりが動き出した。	
総務省が6日発表した家計調査によると、2021年上半期の1世帯当たりのギョーザ購入額で宮崎市が2年連続の首位となり、2位の浜松市に大差をつけた。	<政府活動>,<日本>,<指数・統計>
米司法省は賃金と人材引き抜きに関するカルテルを相次いで摘発。	<政府活動>,<米国>,<法整備・規制>
政府が自宅療養を基本とする方針を示し関連機器の需要が増えている。	<政府活動>,<日本>,<指数・統計>
21年1月に人感センサーによる照明の省エネ技術、屋上に太陽光発電パネルを導入しているオフィスビルに本社を移した。	
同国法務省は9日にも対象者を審査するが、各種世論調査では6~7割が李氏の仮釈放に賛成だ。	<企業活動背景>,<日本>,<法整備・規制>,<検討>
ノババックスのワクチンを巡っては、日本の厚生労働省も22年初頭から1億5千万回分の供給を受けることを前提に、日本での供給を担う武田薬品工業との間で協議している。	<政府活動>,<日本>,<法整備・規制>,<検討>
政府は4日、東京電力ホールディングスが7月に申請していた新しい再建計画「第4次総合特別事業計画」を認定した。	<政府活動>,<日本>,<法整備・規制>
半導体不足で生産に影響が出ているほか、日産は河南省の工場が水害の影響で一時稼働停止したことも響いた。	
金融庁の中島淳一長官は3日、日本経済新聞のインタビューに応じた。	
政府は英アストラゼネカの新型コロナウイルス向けワクチンを医薬品として特例承認したにもかかわらず、2カ月半も接種に使うかどうかを棚上げにした。	<政府活動>,<日本>,<法整備・規制>
政府は7月下旬に交付を始めたが、現時点で有効なのは12カ国・地域にとどまる。	<企業活動背景>,<日本>,<その他>
ロームは、中国自動車大手の吉利汽車と省エネ性能が高い次世代半導体分野で技術提携したことを明らかにした。	
経済産業省は北海道と本州を結ぶ直流の送電線を海底ケーブルで整備する。	<政府活動>,<日本>,<その他>
中国政府は3日、自動車に搭載する半導体の価格をつり上げて独占禁止法に違反した疑いがあるとして半導体販売会社の調査を始めたと発表した。	<政府活動>,<中国>,<その他>
総務省がまとめた2020年度の北海道内市町村のふるさと納税受け入れ額をみると、オホーツク海側の紋別市が2年連続で首位を保った。	<政府活動>,<日本>,<指数・統計>
厚生労働省はジェネリック医薬品を巡り、品質問題や供給トラブルで品薄になっていることを受け、供給不足を生じさせたメーカーへの罰則を新設する。	<政府活動>,<日本>,<その他>
政府が掲げる2050年の温暖化ガス排出実質ゼロの目標達成に向け、二酸化炭素を出さない発電方式の開発が進む。	<企業活動背景>,<日本>,<目標・計画・指針>
総務省がオークション制度の導入を「引き続き検討する」とした報告書案を6月に公表し、今月2日まで意見を募集していたことに応じた。	<政府活動>,<日本>,<補助金・交付金>
日本政府が目標に掲げる2050年の脱炭素のためにはカーボンプライシングの仕組みを今すぐ導入しなければ間に合わない。	<企業活動背景>,<日本>,<目標・計画・指針>
日韓にまたがった半導体サプライチェーンを揺るがした同措置を機に、韓国政府は関連部材の国産化を推し進めた。	<政府活動>,<韓国>,<目標・計画・指針>
総務省が今後認可し、NTT東西が2021年夏にも提供を始める見通し。	<政府活動>,<日本>,<法整備・規制>
経済産業省・中小企業庁は、両者の円滑な関係を目指す「知的財産取引に関するガイドライン」を策定。	<政府活動>,<日本>,<目標・計画・指針>
工業情報化省は26日にデータ安全を含む4分野で、ネット企業への取り締まりを強化すると公表している。	<政府活動>,<日本>,<法整備・規制>
中国政府がネット企業などへの規制を強化していることを受け、投資マネーが中国を避け東南アジアに向かう可能性がある。	<企業活動背景>,<中国>,<法整備・規制>
政府が北海道への「まん延防止等重点措置」適用を決め、北海道は札幌市の飲食店などを対象に酒類提供の停止を要請する。	<政府活動>,<日本>,<法整備・規制>
水産庁が30日発表した2021年の長期漁海況予報では、8~12月に日本近海に来るサンマの量は「20年を上回るものの、19年を下回る」だった。	<政府活動>,<日本>,<指数・統計>
厚生労働省の審議会が30日に指定を了承し、後日、厚労省が正式に指定する。	<政府活動>,<日本>,<法整備・規制>
政府が温暖化ガス排出量削減の目標を打ち出したことを受けて、社内で具体策を検討した。	<企業活動背景>,<日本>,<法整備・規制>,<検討>
農林水産省が30日に公表した8月の野菜卸値見通しによると、調査対象の14品目のうち、ハクサイとキャベツ、キュウリ、ナスの4品目が1カ月を通して平年より2割以上安値になりそうだ。	<政府活動>,<日本>,<指数・統計>
政府は8月2~31日、北海道に緊急事態宣言に準じる「まん延防止等重点措置」を適用する。	<政府活動>,<日本>,<法整備・規制>,<施行>
米司法省は29日、電気自動車の新興メーカー、米ニコラの創業者トレバー・ミルトン元会長を詐欺罪で起訴したと発表した。	<政府活動>,<米国>,<法整備・規制>
司法省と米証券取引委員会が調査に入るなか、昨年9月に会長を辞任していた。	<企業活動背景>,<米国>,<その他>
政府が最初の緊急事態宣言を出した2020年4月、私は山荘に一時的に拠点を移しました。	<企業活動背景>,<日本>,<その他>
新型コロナウイルス禍の影響で主力のテクノロジーソリューション事業で流通業や官公庁などからの受注が落ち込んだ。	
記者会見した松田光司社長は政府が21日に原案を発表したエネルギー基本計画について「再生可能エネルギーの目標はかなり厳しい数字。達成へ最大限努力する」と話した。	<企業活動背景>,<日本>,<その他>
政府は会期中の交通混雑回避へテレワーク導入を呼びかけていたが、コロナ禍を機に各社が一斉に導入したことから、対応は追加拡大策が中心だ。	<企業活動背景>,<日本>,<その他>
農林水産省は29日、2021年産の主食用米の生産量が前年に比べ約4%減り、統計がある08年以降で最も少なくなるとの見通しを発表した。	<政府活動>,<日本>,<指数・統計>
人口減少や新型コロナウイルス禍などでコメの消費は落ち込んでおり、農水省は需要に見合う生産を産地に促していた。	<政府活動>,<日本>,<目標・計画・指針>
セキュリティー会社のトレンドマイクロは29日、小中学生に1人1台のパソコンなどを配備する政府の「GIGAスクール構想」に関する調査結果を発表した。	
経済産業省と東京証券取引所がデジタル時代を先導する企業を毎年選ぶ「DXグランプリ」で、2021年に日立製作所と並んでトップに選出されたのが不動産事業やコンサルティングなどを手掛けるSREホールディングスだ。	<企業活動背景>,<日本>,<その他>
プラスチックによる環境汚染に対し中国政府が近年相次いで対策を打ち出す中、中国では生分解性プラスチック業界が急成長している。	<企業活動背景>,<中国>,<その他>
資源エネルギー庁が28日発表した26日時点のレギュラーガソリンの店頭価格は前週に比べ0.1円高い1リットル158.4円だった。	<政府活動>,<日本>,<指数・統計>
経済産業省や国土交通省などは2030年までに新築戸建て住宅の約6割に太陽光発電設備を設置する目標を設ける検討に入った。	<政府活動>,<日本>,<目標・計画・指針>
河野太郎規制改革相のもとに設けた再生エネに関するタスクフォースで27日、経産省、国交省、環境省の3省が表明した。	<政府活動>,<日本>,<その他>
農林水産省は27日、大阪堂島商品取引所が申請したコメ先物取引の本上場への移行について、現時点で認可基準を満たしていないとの判断を明らかにした。	<政府活動>,<日本>,<法整備・規制>
フランス政府はワクチン接種の義務化を目指しています。	<政府活動>,<フランス>,<目標・計画・指針>
政府も少子化対策を重視するなか、スタートアップの活躍できる場面は拡大する可能性が高い。	
米商務省が26日発表した6月の新築一戸建て住宅販売件数は67万6000戸で、前月比6.6%減少した。	<政府活動>,<米国>,<指数・統計>
総務省が産業向けの周波数を広げたことを機に、免許の取得や申請数は半年で2倍に増えた。	<政府活動>,<日本>,<指数・統計>
オーストラリアが拠点の非政府組織、マーケット・フォースは3月、住友商事と三菱UFJフィナンシャル・グループに対し、気候変動に関する戦略策定や情報開示を求める株主提案を出した。	
中国政府は26日、ネット企業を対象に独占禁止法の順守やデータ安全など4分野に関して集中的に取り締まると発表した。	<政府活動>,<中国>,<その他>
工業情報化省がこのほどネット企業を集中的に取り締まるアクションプランを正式に始める会議を開いた。	<政府活動>,<日本>,<国際会議・会合・会談>
劉氏は「各国政府が工場誘致を活発化し、当社の現地生産を望んでいる」との現状を明らかにした。	
政府は農村や離島、都市など100以上の先行地域を選び補助金を出すなどして、脱炭素の街「ゼロカーボンシティ」の実現を後押しする。	<企業活動背景>,<日本>,<補助金・交付金>
省エネ機器製造のMIRAI-LABOは光とリチウムイオン電池の制御技術で省エネ機器を製造する。	
シンガポールの政府系大手複合企業、ケッペル・コーポレーションとセムコープ・インダストリーズが「脱石油」を軸とする事業再編を急いでいる。	
文部科学省は2030~40年代を見据えた次世代の宇宙輸送機の開発方針を大筋でまとめた。	<政府活動>,<日本>,<目標・計画・指針>
民家を改装した定食店に県庁職員が吸い込まれていく。	
金融庁は脱炭素を金融面で後押しする取り組みを強化する。	<政府活動>,<日本>,<法整備・規制>
経済産業省が原案を公表した新しいエネルギー基本計画は、再生可能エネルギーや原子力発電所で最大限の稼働をめざすが、2030年度の発電量のうち4割はなお火力で担う。	<企業活動背景>,<日本>,<法整備・規制>
政府は海外渡航者へのワクチン証明の申請受け付けを26日から始める。	<政府活動>,<日本>,<その他>
21日に公表されたエネルギー基本計画の原案で、経済産業省は2030年度の電源に占める原子力の比率を20~22%とする現行の目標値を維持した。	<政府活動>,<日本>,<指数・統計>
定款変更まで求める株主提案をした環境系非政府組織、豪マーケット・フォースの代理人だ。	
配送状況などのデータがやり取りでき、検品の省略も期待できる。	
経済産業省が21日に公表した新たなエネルギー基本計画の原案で再生可能エネルギーを「主力電源として最優先の原則のもとで最大限の導入に取り組む」と明記した。	<政府活動>,<日本>,<法整備・規制>
経済産業省は21日、新しいエネルギー基本計画の原案を公表した。	<政府活動>,<日本>,<目標・計画・指針>
経済産業省は21日、新しいエネルギー基本計画の原案を総合資源エネルギー調査会の基本政策分科会で示した。	<政府活動>,<日本>,<目標・計画・指針>
資源エネルギー庁が21日発表した19日時点のレギュラーガソリンの店頭価格は前週比0.3円上昇し、1リットル158.3円だった。	<政府活動>,<日本>,<指数・統計>
経済産業省は21日、新しいエネルギー基本計画の原案を公表した。	<政府活動>,<日本>,<目標・計画・指針>
総務省が20日に始めたプロジェクトに参加する。	<企業活動背景>,<日本>,<国際会議・会合・会談>
新型コロナウイルスの中でも感染力の強いインド型の流行で旅客収入が大きく減り、計画投資省は経営破綻の可能性を指摘した。	<政府活動>,<インド>,<指数・統計>
ベトナムは周辺国よりも感染の拡大を抑えてきたが、大株主である政府の厳しい防疫と財政難が業績の悪化に拍車をかけている。	
現地メディアによると、ベトナム計画投資省が2020年と21年1~5月の国内航空会社の経営に関するリポートをまとめた。	<政府活動>,<ベトナム>,<目標・計画・指針>
食品・日用品大手ユニリーバの子会社で米アイスクリーム製造販売の「ベン&ジェリーズ」がイスラエルのパレスチナ占領地で商品販売の停止を決定したことに対し、イスラエル政府は20日、「深刻な結果を招くもの」と警告、販売停止の撤回を求めた。	<政府活動>,<イスラエル>,<法整備・規制>,<廃止>
経済産業省はクレジットカード会社がやりとりする手数料の開示を要請する。	<政府活動>,<日本>,<法整備・規制>
政府の観光需要喚起策「Go To、トラベル」キャンペーンが行われた前年を下回り、新型コロナウイルス感染の影響が出る前の2019年比だと8割減の水準にとどまっている。	<政府活動>,<日本>,<指数・統計>
総務省は主要プロバイダーからの集計数値をもとに、光ファイバー回線などの通信量を年に2回推計している。	<政府活動>,<日本>,<指数・統計>
タイ運輸省傘下の民間航空局は首都バンコクの空港などを発着する国内線の運航を21日から原則禁止すると発表した。	<政府活動>,<タイ>,<法整備・規制>
政府は12日からバンコクなど10都県で始めた事実上のロックダウンを、20日から13都県に拡大する。	<政府活動>,<日本>,<法整備・規制>
農林水産省がまとめた2020年産米の6月分の相対取引価格は1俵あたりの全銘柄平均で前年同月に比べて9%安い1万4225円だった。	<政府活動>,<日本>,<指数・統計>
仏政府も前面に出て育成する姿勢を明確にしており、仏スタートアップの年間資金調達額は過去5年で約3倍になった。	<政府活動>,<フランス>,<指数・統計>
厚生労働省は19日開く専門部会で、中外製薬が承認を申請している治療薬候補について審議する。	<政府活動>,<日本>,<法整備・規制>,<検討>
政府は2030年度の新たな電源構成の原案について、総発電量に占める再生可能エネルギーの比率を36~38%、原子力を20~22%とする方向で最終調整に入った。	<政府活動>,<日本>,<その他>
経済産業省が21日に開く総合資源エネルギー調査会の基本政策分科会で、国のエネルギー政策の方向性を記すエネルギー基本計画と電源構成の原案を示す。	<政府活動>,<日本>,<目標・計画・指針>
米商務省が16日発表した6月の小売売上高は6213億ドルで前月の改定値から0.6%増加した。	<政府活動>,<米国>,<指数・統計>
政府はグルメサイトの「食べログ」「ぐるなび」「ホットペッパーグルメ」と協力する。	<政府活動>,<日本>,<その他>
野菜栽培はコメなどに比べて省力化が遅れているとされ、農家の負担軽減とともに収穫量や品質の安定につなげる。	
富山県は15日、政府が目指す2050年の温暖化ガス排出実質ゼロに向けて「グリーン成長戦略分野」を設けると発表した。	<政府活動>,<日本>,<目標・計画・指針>
札幌市の直近7日間の新規感染者数は、政府がまん延防止措置の適用目安としている人口10万人あたり15人を超えた。	
中国政府は国内メーカーの生産能力が依然として過剰な状態にあるとの見方を崩していない。	<政府活動>,<中国>,<その他>
米政府が予定するTSMCへの補助金は、米国の競争力をかえって損なうとの主張だ。	<企業活動背景>,<米国>,<その他>
ただ米政府は半導体の過度なアジア依存から脱し、中国に対抗しようとTSMCを国内に誘致した。	<政府活動>,<米国>,<補助金・交付金>
政府が議論しているデジタル給与が解禁されれば、資産運用サービスなども検討する。	<企業活動背景>,<日本>,<法整備・規制>
出入国在留管理庁が15日発表した外国人入国者数によると、6月の外国人入国者の数は1万7280人だった。	<政府活動>,<日本>,<指数・統計>
環境省と経済産業省は陸上風力発電所の環境影響評価の期間を短縮する制度の検討を始める。	<政府活動>,<日本>,<法整備・規制>,<検討>
英スコットランド政府が世界最大級の開発を計画しており、日本から丸紅が16日に締め切る入札への参加を決めた。	<政府活動>,<英国>,<目標・計画・指針>
資源エネルギー庁が14日発表した12日時点のレギュラーガソリンの店頭価格は前週比0.5円上昇し、1リットル158.0円だった。	<政府活動>,<日本>,<指数・統計>
2030年度の温暖化ガス排出量の削減目標達成には、発電量に占める再生可能エネルギーの比率を36〜38%に高める必要があると経済産業省が試算していることがわかった。	<政府活動>,<日本>,<その他>
政府は4月、30年度の温暖化ガス排出量を13年度比で46%以上減らす目標を決めた。	<政府活動>,<日本>,<目標・計画・指針>
SNSなどネット上の誹謗中傷や偽情報を議論する総務省の有識者会議は14日、中間提言案をまとめた。	<政府活動>,<日本>,<法整備・規制>,<検討>
ジェネリック医薬品メーカーの小林化工や日医工などで相次いで品質不正が発覚したことを受け、厚生労働省と沖縄県を除く46の都道府県が各地の後発薬などの製造工場に立ち入り検査していたことが14日分かった。	<政府活動>,<日本>,<法整備・規制>
政府は新型コロナウイルス対策に伴う緊急事態宣言地域で酒類を提供する飲食店に休業を要請している。	<政府活動>,<日本>,<法整備・規制>
米農務省が同日発表した7月の需給報告で、2021~22年度の世界と米国の小麦の期末在庫量見通しが市場予想を下回り、強材料とみなされた。	<政府活動>,<米国>,<指数・統計>
経済産業省は13日、2021年7~9月期の国内粗鋼生産量が前年同期比30%増の2469万トンになるとの見通しを発表した。	<政府活動>,<日本>,<指数・統計>
政府は13日、首相官邸で開いた知的財産戦略本部で「知的財産推進計画2021」を決定した。	<政府活動>,<日本>,<目標・計画・指針>
経産省は12日、30年の1キロワット時あたりの発電コストの試算を公表。	<政府活動>,<日本>,<目標・計画・指針>
政府目標では30年度に温暖化ガスの排出量を13年度比で46%以上削減する。	<政府活動>,<日本>,<目標・計画・指針>
通信サービスの消費者保護を議論する総務省の有識者会議は12日、報告書案をまとめた。	<政府活動>,<日本>,<法整備・規制>
総務省は一般から意見を公募し、2022年以降に関連省令やガイドラインを改正する見通しだ。	<政府活動>,<日本>,<法整備・規制>,<改正>
蘇寧の業績は急速に悪化しており、5日には政府系のファンドが立ち上げた基金からの資金調達を発表したばかり。	
厚生労働省は12日、中外製薬が製造販売承認を申請している新型コロナウイルス向け治療薬候補について19日の専門部会で審議すると発表した。	<政府活動>,<日本>,<法整備・規制>,<検討>
経済産業省は2030年度の総発電量を現行計画から1割程度減らす検討に入った。	<政府活動>,<日本>,<法整備・規制>,<検討>
経済産業省は12日、2030年時点の1キロワット時あたりの発電コストが原子力よりも太陽光の方が安くなるとの試算を明らかにした。	<政府活動>,<日本>,<その他>
中国政府は2023年にサイバーセキュリティー産業の規模を20年の1.5倍の2500億元まで引き上げる。	<政府活動>,<中国>,<目標・計画・指針>
ハイテク分野を管轄する工業情報化省が12日、サイバーセキュリティー産業の育成を加速する3カ年計画の草案を発表した。	<政府活動>,<日本>,<目標・計画・指針>
経済産業省と日本繊維産業連盟は綿などの調達先で不当賃金や児童労働などの問題がないか企業が確認する指針をつくる。	<政府活動>,<日本>,<その他>
121ページにわたる報告書には、東芝と経産省の幹部、そして投資ファンドとのやりとりが克明に描かれています。	
政府が8日に東京都への4度目の緊急事態宣言の発令を決めたことなどを受けた措置。	<企業活動背景>,<日本>,<目標・計画・指針>
携帯電話料金などの競争ルールを議論する総務省の有識者会議は9日、報告書案をまとめた。	<政府活動>,<日本>,<法整備・規制>
政府は8日、東京電力福島第1原子力発電所の敷地内にたまる処理水の処分を巡り、国際原子力機関と協力することで合意したと発表した。	<政府活動>,<日本>,<その他>
政府は4月に処理水を海洋放出する方針を決めた。	<政府活動>,<日本>,<目標・計画・指針>
インド政府はツイッターの規制違反を問題視し、投稿内容に関する同社の免責措置を解除すると主張していた。	<政府活動>,<インド>,<法整備・規制>,<廃止>
インド政府は2月にSNS運営企業などに対する規制を発表し、不適切とされる投稿の削除規定などを定めた。	<政府活動>,<インド>,<法整備・規制>
沖縄県は8日、政府が新型コロナウイルス対策の緊急事態宣言の期間延長を決めたことを受け、新たな対処方針を決定した。	<企業活動背景>,<日本>,<法整備・規制>
経済産業省は8日、アラブ首長国連邦のアブダビ国営石油会社とJERA、INPEXが燃料アンモニアの供給網をつくるために調査を始めると発表した。	<政府活動>,<アラブ首長国連邦>,<その他>
耐火木材と鉄骨のハイブリッド構造とし、国が推進する省エネビル「ZEB」の新技術も取り入れた先駆的な建築物になる。	
経済産業省は8日、脱炭素技術の開発を支援する2兆円の基金のうち、水素やアンモニアを燃料とする次世代航空機・船舶の2事業に最大560億円を配分する方針を決めた。	<政府活動>,<日本>,<目標・計画・指針>
政府は8日、東京都に4度目の緊急事態宣言を発令した。	<政府活動>,<日本>,<法整備・規制>
中国政府がインフレ抑制のため商品価格の規制を強化した影響がゴムにも波及するとの観測が強まり、参加者が売買を控えたことが直接の理由。	<企業活動背景>,<中国>,<法整備・規制>
東京電力福島第1原子力発電所の廃炉には「30~40年かかる」といわれ、東電と政府の工程表は2051年までの終了を目指している。	
ダイキン工業は電気自動車のエアコンに使う省エネ性能の高い冷媒を開発した。	
資源エネルギー庁が7日発表した5日時点のレギュラーガソリンの店頭価格は前週比1.2円高い1リットル157.5円だった。	<政府活動>,<日本>,<指数・統計>
米国防総省は6日、情報システム基盤の刷新に向けたクラウドサービスの大型契約を解除し、提案を再募集すると発表した。	<政府活動>,<米国>,<補助金・交付金>
インド政府と米ツイッターの対立が激化している。	
インド政府はIT規制違反を理由に、不適切な投稿に関するツイッターの免責措置が解除されると主張した。	<政府活動>,<インド>,<法整備・規制>,<廃止>
中国政府が自国のインターネット大手への統制を強化している。	<政府活動>,<中国>,<法整備・規制>
文部科学省は6日、理化学研究所のスーパーコンピューター「富岳」を使い、国立競技場に1万人の観客を収容した場合の感染リスクをシミュレーションで調べた結果を公表した。	<政府活動>,<日本>,<目標・計画・指針>
中国の小売り大手、蘇寧易購集団は6日までに、創業者らが保有する蘇寧株16%超を政府系ファンドが立ち上げた基金に約88億元で売却すると発表した。	
農林水産省が6日発表した食品価格動向調査によると、6月28日の週は調査対象の8品目のうちレタスやバレイショなど4品目の小売価格が前の週に比べ下落した。	<政府活動>,<日本>,<指数・統計>
日本の半導体産業の再興に向けた政府の戦略が発表された。	<政府活動>,<日本>,<目標・計画・指針>
各国、地域の政府が大規模な財政支援を打ち出す中、日本の半導体政策には何が必要か。	<企業活動背景>,<日本>,<その他>
日本の半導体産業の再興に向けた政府の戦略が発表された。	<政府活動>,<日本>,<目標・計画・指針>
各国、地域の政府が大規模な財政支援を打ち出す中、日本の半導体政策には何が必要か。	<企業活動背景>,<日本>,<その他>
メキシコ湾南部のザマ油田を巡り、メキシコのエネルギー省が運営会社として国営石油会社ペメックスを選ぶ方針を示したことが明らかになった。	<政府活動>,<メキシコ>,<目標・計画・指針>
ツイッターやフェイスブックなどネット上の言論やコンテンツを政府が削除命令できる「新IT規則」を5月26日に発効させると今度は6月21日、ネット通販サイトの時限値引きセール禁止などを盛り込んだ新たな電子商取引規則案を発表した。	<企業活動背景>,<日本>,<法整備・規制>,<施行>
メキシコ政府が目指すガソリン100%自給の目標に沿った動きで、英蘭ロイヤル・ダッチ・シェルと共同運営してきた米テキサス州の製油所を買い取ることを決めた。	<企業活動背景>,<米国>,<目標・計画・指針>
警察庁もサイバー局新設など体制強化に取り組むが、捜査権限の議論を欠き、頼りなさが残る。	<企業活動背景>,<日本>,<法整備・規制>
米紙ウォール・ストリート・ジャーナルは2日、米司法省が電気自動車の新興メーカー、米ローズタウン・モーターズの調査を始めたと報じた。	<政府活動>,<米国>,<その他>
政府は省庁横断チームを設け、マネロン対策の不備を修正する法改正などを急ぐ。	<政府活動>,<日本>,<法整備・規制>,<改正>
韓国政府は2日、日本の輸出管理厳格化から2年を迎えて「素材・部品・装置産業成果報告会」を開いた。	<政府活動>,<韓国>,<国際会議・会合・会談>
韓国政府が指定する「核心100品目」の対日依存度が2年間で31.4%から24.9%に下がったと強調した。	<政府活動>,<韓国>,<指数・統計>
米農務省が6月末発表した2021~22年度の米農家のトウモロコシの推定作付面積は9270万エーカーと市場の事前予想を下回ったことが材料視された。	<政府活動>,<米国>,<指数・統計>
米商務省が1日発表した5月の米建設支出額は1兆5453億ドルで、前月の改定値から0.3%減った。	<政府活動>,<米国>,<指数・統計>
経済産業省は新型コロナウイルス禍で業績が落ち込む百貨店業界の体制を強化するため、販売や物流面で連携を検討する作業部会を今年度内にも設ける。	<政府活動>,<日本>,<その他>
三菱電機がブレーキに使う空気圧縮機で不適切な検査をしていたことが発覚し、国土交通省が1日までに鉄道会社に対して一斉点検を要請した。	<政府活動>,<日本>,<法整備・規制>
国土交通省が鉄道事業者に入念な点検と早急な報告をするよう通達を出したと説明した。	<政府活動>,<日本>,<その他>
政府は原子力政策の先送りを続けてきたが、「人材の崖」が決断を迫っている。	<企業活動背景>,<日本>,<目標・計画・指針>
国税庁が1日発表した2021年の路線価で、九州7県の標準宅地の評価基準額は前年比0.4%上昇した。	<政府活動>,<日本>,<指数・統計>
路線価は相続税や贈与税の算定基礎となり、全国に524カ所ある税務署ごとの最高価格を国税庁が集計した。	
農林水産省が30日に公表した7月の野菜卸値見通しによると、調査対象の14品目のうち、レタスとハクサイが1カ月を通して平年より安値になりそうだ。	<政府活動>,<日本>,<指数・統計>
政府のデジタル市場競争会議の作業部会は30日、スマートフォンに搭載する基本ソフト市場を巡り、巨大IT企業の取引実態を調べると発表した。	<政府活動>,<日本>,<その他>
資源エネルギー庁が6月30日発表した6月28日時点のレギュラーガソリンの店頭価格は前週比0.7円上昇し、1リットル156.3円だった。	<政府活動>,<日本>,<指数・統計>
ドイツ政府は22日、メルケル首相が米モデルナ製ワクチンを接種したことを明らかにした。	<政府活動>,<ドイツ>,<その他>
総務省は29日、携帯大手などが今春に提供を始めた割安プランへの乗り換え件数が約1570万件だったと発表した。	<政府活動>,<日本>,<その他>
消費者庁は29日までに、人気オンラインゲーム「ファイナルファンタジー」でキャラクターなどを購入する電子くじ「ガチャ」を巡り、ゲーム内の宣伝が景品表示法違反に当たるとして、ゲーム会社「スクウェア・エニックス」と「gumi」に再発防止を求める措置命令を出した。	<政府活動>,<日本>,<法整備・規制>
日本オラクルと住環境計画研究所は29日、人の心理に働きかけて行動変容を迫る「ナッジ理論」を応用した省電力化の実証実験の結果を公表した。	
民間製造業の発注は9.6%落ち込んだが、非製造業と官公庁の発注が下支えした。	
政府は新型コロナウイルスワクチンの接種証明書を7月中旬にも発行する予定だ。	<政府活動>,<日本>,<法整備・規制>,<施行>
政府が50年までに温暖化ガスの排出量を実質ゼロにする「カーボンニュートラル」を目指すなか、脱炭素の技術開発を急ぐ。	<企業活動背景>,<日本>,<目標・計画・指針>
経済産業省は28日、「メタネーション」の普及に向けた官民協議会の初会合を開いた。	<政府活動>,<日本>,<国際会議・会合・会談>
経済産業省はドローンや人工知能を使った電気設備の保守・点検手法の確立に向け、今夏をめどに有識者による検討会を発足させる。	<政府活動>,<日本>,<その他>
政府は25日、申請の受け付けを一時停止。	<政府活動>,<日本>,<法整備・規制>,<廃止>
日本の金融庁も25日に警告を出した。	<政府活動>,<日本>,<その他>
東南アジアの政府系航空大手2社の経営再建が遅れている。	
公的支援を求めているが、政府は財政悪化を受けて及び腰だ。	<政府活動>,<日本>,<その他>
終戦直後、群馬県内にあった政府のコーヒー豆が許可なく払い下げられて公務員汚職疑惑に発展した。	
中小企業庁が近く登録制を導入するほか、自主規制団体の発足も目指す。	<政府活動>,<日本>,<その他>
総務省は防犯カメラなどの機器を乗っ取って標的にサイバー攻撃をしかける指令元のサーバーを迅速に検知できるよう法解釈を整理する。	<政府活動>,<日本>,<法整備・規制>,<検討>
スバルは2017年に発覚した無資格者による完成検査問題を発端に大規模なリコールに追い込まれた反省を踏まえ、不正防止を徹底する。	
2050年に温暖化ガス排出量を実質ゼロにするという政府目標の実現に向けて、忘れてならないのは農業分野の削減だ。	
国税庁はこのたび、国税に関する手続きなどを抜本的に見直す計画を公表した。	<政府活動>,<日本>,<法整備・規制>,<検討>,<改正>
政府はワクチンが不足する可能性があるとして、企業や大学からの職場接種の申請受け付けを一時停止すると発表したが、スターフライヤーと西鉄によると、申請は24日に完了したという。	<企業活動背景>,<日本>,<法整備・規制>
各国政府が進めるワクチン接種の体制整備などに役立ててもらい、経済回復を支援する。	<企業活動背景>,<日本>,<補助金・交付金>
韓国政府が日本への依存度の高い品目で国産化を推進する「脱日本」は道半ばだ。	<企業活動背景>,<日本>,<その他>
どの国のメーカーが真っ先に量産にこぎつけるかが関心の的で、政府が18日に発表した成長戦略で半導体技術の再興とともに、国内企業による実用化への期待を打ち出した。	<政府活動>,<日本>,<目標・計画・指針>
厚生労働省も国内の報告をまとめており、専門家は「接種の恩恵はリスクを上回る」と口をそろえる。	<政府活動>,<日本>,<指数・統計>
筆頭株主の財務相の代理として財務省職員が質問するなど注目を集めた。	
米商務省が23日発表した5月の新築一戸建て住宅販売件数は76万9000戸で、前月比5.9%減少した。	<政府活動>,<米国>,<指数・統計>
省庁が同システムを導入すると、利用者は交通違反金や旅券発行などの支払いでクレジットカードを使えるようになる。	<政府活動>,<日本>,<その他>
省庁は窓口業務を軽減できる。	<政府活動>,<日本>,<その他>
資源エネルギー庁が23日発表した21日時点のレギュラーガソリンの店頭価格は前週比1.1円上昇し、1リットル155.6円だった。	<政府活動>,<日本>,<指数・統計>
中国政府は23日、国有IT大手2社の経営統合を認可したと発表した。	<政府活動>,<中国>,<法整備・規制>
筆頭株主である仏政府の意向も背景にあり、同社は2030年までに温暖化ガス排出量を05年比で実質半分にする目標達成に弾みをつける。	
ただメキシコ政府は民間のEV向け投資の後押しに消極的なままで、国内の販売市場の拡大にも時間はかかりそうだ。	<政府活動>,<メキシコ>,<その他>
争点はインド政府が2月25日に突然発表し、5月26日に発効させた新しい「2021年IT規則」だ。	<企業活動背景>,<インド>,<法整備・規制>,<施行>
同規則は、SNSなどオンラインプラットフォームへの第三者による投稿の内容について、政府が「違法」と認定すれば裁判抜きに削除を命令できるとした。	<企業活動背景>,<日本>,<法整備・規制>
農林水産省が22日発表した食品価格動向調査によると、6月14日の週は調査対象の8品目のうちレタスやキュウリなど4品目の小売価格が前週比で値下がりした。	<政府活動>,<日本>,<指数・統計>
日本公認会計士協会の手塚正彦会長は22日の記者会見で、東芝の2020年の株主総会の運営に経済産業省が介入したとされる問題について「事実なら非常に由々しき問題」と指摘した。	
厚生労働省の有識者検討会は22日、人工知能などの新技術を導入する場合に、労使のコミュニケーションが重要になると明記した報告書をまとめた。	<政府活動>,<日本>,<法整備・規制>
不法残留している外国人を配達員として雇い、不法就労を助長したとして、警視庁は22日、料理宅配最大手「ウーバーイーツ」を運営する日本法人の代表ら2人と、法人としての同社を入管難民法違反の疑いで書類送検した。	<政府活動>,<日本>,<法整備・規制>
政府が脱炭素を推進し、関連ビジネスが拡大するとみて体制を強化する。	<企業活動背景>,<日本>,<法整備・規制>
オーストラリアで進む大規模な水素製造事業について、豪連邦政府が環境への懸念から事業を進めるための認可を出さなかったことが21日わかった。	<政府活動>,<オーストラリア>,<法整備・規制>
計画は2020年に政府が国家的に重要な意義を持つ「主要プロジェクト」として認定していた。	<企業活動背景>,<日本>,<法整備・規制>
経済産業省は21日、原子力発電所8基が立地する福井県で、原発依存低減に向けた新産業を地元自治体と検討する会議を開いた。	<政府活動>,<日本>,<国際会議・会合・会談>
政府が提供する米モデルナ製ワクチンを使う。	<政府活動>,<日本>,<目標・計画・指針>
金融庁は18日、コインベースを改正資金決済法に基づく暗号資産交換業者として登録したと発表した。	<政府活動>,<日本>,<その他>
金融庁と東京証券取引所が6月に改訂したコーポレートガバナンス・コードに、知的財産の活用などを促す内容が加わった。	<政府活動>,<日本>,<法整備・規制>,<改正>
総務省は18日、全国の高等専門学校生から提案を募った「高専ワイヤレスIoTコンテスト」に2021年度は12件を採択したと発表した。	<政府活動>,<日本>,<法整備・規制>
経済産業省は18日、全国の中小企業のキャッシュレス決済の導入状況に関する調査結果を公表した。	<政府活動>,<日本>,<その他>
農林水産省は18日、2020年産米の5月分の相対取引価格を発表した。	<政府活動>,<日本>,<その他>
30年度の温暖化ガス排出量を13年度に比べて46%削減する目標を政府が4月に決めたことに対応する。	<企業活動背景>,<日本>,<目標・計画・指針>
7月に設立される仙台村田製作所の社長に就任予定の橋本省吾氏は、同拠点で生産する電子部品の生産量を2022年度中に1割増やす方針を示した。	
米政府が国内市場から中国製の通信機器を徹底的に排除する。	<政府活動>,<米国>,<法整備・規制>
政府と取引がない民間企業にも販売できないようにして「抜け穴」を封じる。	
農林水産省はITで農作業を効率化する「スマート農業」の普及に向けた技術情報の一元化に着手する。	<政府活動>,<日本>,<その他>
政府は25年に4割を目指しているが、主要各国では既に4~6割台で、普及は遅れている。	<企業活動背景>,<日本>,<目標・計画・指針>
主要7カ国首脳会議の合意を受け、日本政府は石炭火力発電の輸出支援を年内にやめる。	<政府活動>,<日本>,<法整備・規制>,<廃止>
国土交通省が資源活用を促しており、企業が地方自治体と共同で事業化するケースが増えている。	<政府活動>,<日本>,<指数・統計>
「携帯電話料金値下げ」を目玉政策に掲げる菅義偉政権が2020年9月に誕生して以降、キャリアに対する政府からの値下げ圧力が強まった。	
政府が医療用と一般用のマスクについて性能の目安となる日本産業規格を定めたことを受けて、アイリスオーヤマは生産する全製品を22日に申請すると発表した。	<企業活動背景>,<日本>,<法整備・規制>
経済産業省は17日、社員の健康に配慮した経営をしている441社の評価内容を公表した。	<政府活動>,<日本>,<その他>
政府は21日以降、北海道を緊急事態宣言に準じた対策が可能となる「まん延防止等重点措置」の対象とする方針だ。	<政府活動>,<日本>,<目標・計画・指針>
政府が掲げた「2050年に温暖化ガス排出実質ゼロ」の目標達成に向け、地熱発電の利用を促す技術開発が進む。	<企業活動背景>,<日本>,<目標・計画・指針>
駆動モーターの開発拠点として稼働した江蘇省蘇州市では、2022年3月までに現在の約5割増の250人に増やす。	
モーターの新工場が6月から本格稼働した遼寧省大連市では、既存工場と合わせて4割増の5000人規模にする。	
米商務省が16日発表した5月の住宅着工件数は、前月比3.6%増の157万2千戸だった。	<政府活動>,<米国>,<指数・統計>
資源エネルギー庁が16日発表した14日時点のレギュラーガソリンの店頭価格は前週比1.6円上昇し、1リットル154.5円だった。	<政府活動>,<日本>,<指数・統計>
厚生労働省は16日、新型コロナウイルス感染症の後遺症に関する実態調査の結果を発表した。	<政府活動>,<日本>,<その他>
天候に左右されにくい省人化の大規模工場が普及すれば、デジタル化が遅れる農業の「カイゼン」になる。	
政府は5月にアストラゼネカ製を承認し、3000万回分を海外へ出荷する方針を明らかにしている。	<政府活動>,<日本>,<法整備・規制>
農林水産省が15日に発表した食品価格動向調査によると、6月7日の週では調査対象の8品目のうち4品目が平年比で値下がりした。	<政府活動>,<日本>,<指数・統計>
独政府の「経済安定化ファンド」が議決権を持たない「サイレントパーティシペーション」方式で注入した公的資金の返済にあてるほか、資本構造の強化にもつなげる。	
総務省の有識者会議は14日、携帯電話事業者に割り当てた周波数帯について、ほかの事業者が利用を希望する場合などに再配分できる仕組みを求める報告書案をまとめた。	<政府活動>,<日本>,<法整備・規制>
総務省は14日、放送事業者に対する外資規制の審査強化に向けた有識者会議の初会合を開いた。	<政府活動>,<日本>,<国際会議・会合・会談>
東芝の臨時株主総会で選任された弁護士がまとめた報告書は、東芝と経済産業省が一体となって株主提案権の行使を妨げようと画策し、一部の海外株主に不当な圧力をかけていたと結論づけました。	<政府活動>,<日本>,<法整備・規制>
かたや、経産省は日本の企業統治改革の旗振り役です。	
金融庁は参入に半年から1年程度かかっていた行政手続きを大幅に短縮する。	<政府活動>,<日本>,<法整備・規制>,<改正>
東芝の株主総会に経済産業省が介入した疑いが生じている問題は、政府が海外からの民間投資にどこまで関与できるのかという論点を浮かび上がらせた。	
実験は国土交通省が進める次世代交通サービス「MaaS」の推進・支援事業に選ばれている。	<企業活動背景>,<日本>,<目標・計画・指針>
米農務省が10日発表した6月の需給報告で、2020~21年度の米国産の期末在庫見通しを2812万トンと前月から下方修正した。	<政府活動>,<米国>,<指数・統計>
金融庁が2015年に金融商品取引法改正などで解禁した。	<政府活動>,<日本>,<法整備・規制>
政府は11日、日本製のステンレス製品に対する中国の反ダンピング課税について、世界貿易機関協定に基づく2国間の協議を要請した。	<政府活動>,<日本>,<税制・予算>
日本政府観光局の清野智理事長は日本経済新聞のインタビューに応じ、新型コロナウイルスの感染拡大の前に政府が掲げた「2030年に訪日外国人6000万人」の目標を巡り「ワクチン接種のスピードが上がって国内の受け入れ体制が整えば、現時点でも実現可能だ」との認識を示した。	<政府活動>,<日本>,<指数・統計>
政府が定める接種期間が延長された場合は延長する。	
経産省が一企業の総会運営に関与したとすれば、日本企業の企業統治が問われる事態となる。	<政府活動>,<日本>,<その他>
この総会では、経済産業省の元参与が東芝の株主に対し、議決権を行使しないよう圧力をかけたとの疑いが指摘されていた。	
世界3位の潜在量を持ちながら原子力優先で出遅れた日本も、政府が2030年に発電所を倍増させる方針を掲げ、にわかに「地殻変動」が起きている。	<政府活動>,<日本>,<目標・計画・指針>
新型コロナウイルスのワクチン普及に伴う経済再開や政府の景気刺激策などが消費活動を押し上げているという。	
米製薬大手メルクは9日、開発中の新型コロナウイルス治療薬170万回分について、米国政府が12億ドルで購入すると合意したと発表した。	<政府活動>,<米国>,<補助金・交付金>
政府が策定する次期エネルギー基本計画で、2030年に再エネの発電比率を40%超とする目標設定を改めて求めた。	<政府活動>,<日本>,<法整備・規制>
環境、厚生労働、国土交通の各省や金融庁などの政府系サイトが一時的に閲覧できなくなったと言及した。	<政府活動>,<日本>,<その他>
8日に起きた米fastlyによる世界的な大規模システム障害で、ウェブサイトの閲覧不能や取引の一時停止に見舞われた企業や政府機関のサイトは数千件に上った。	
米労働省が8日発表した4月の雇用動態調査によると、非農業部門の求人件数は、前月から99万8000件増の928万6000件となり、前月に続き統計開始の2000年12月以来最高を更新した。	<政府活動>,<米国>,<指数・統計>
政府が実現を目指す50年の「カーボンニュートラル」を追い風に、家庭での「オール電化」を加速させる。	<企業活動背景>,<日本>,<目標・計画・指針>
政府は8日、2021年版の科学技術・イノベーション白書を決定した。	<政府活動>,<日本>,<目標・計画・指針>
職場や大学での新型コロナウイルスワクチンの接種について、政府への申請が8日始まった。	
冒頭に総務省の竹内芳明総合通信基盤局長は「ポスト・ニューノーマルでは、デジタル化とグリーン化が成長のカギになる」と述べた。	<政府活動>,<日本>,<その他>
米司法省は7日、米東海岸の燃料パイプラインがランサムウエアによる攻撃を受けて停止した問題で、犯行グループに支払われた身代金の大部分を奪還したと発表した。	<政府活動>,<米国>,<その他>
機械設計・省力化機器製造のジータは部品などの仕分け作業を支援するシステムを開発した。	
安価な省力化システムとして、完全自動化などの大規模投資が難しい企業向けに売り込む。	
経済産業省の幹部は「1年越しのラブコールだった。もう小林さんしかいないんだ」と胸をなで下ろした。	
政府が脱炭素社会の目標を掲げる中でEVなどの需要増加を見込み、環境対応のサービスを拡充する。	<企業活動背景>,<日本>,<目標・計画・指針>
工場の自動化・省力化ニーズが伸びている。	
特別調査委員会がまとめた報告書によると、NTTデータの幹部と総務省幹部職員との会食は2019年11月と20年7月の2回。	<政府活動>,<日本>,<指数・統計>
政府が掲げる2050年までに温暖化ガス排出量を実質ゼロにする目標の達成に貢献できると期待している。	<企業活動背景>,<日本>,<その他>
日本経済新聞社と総務省が主催する「世界デジタルサミット2021」が7日開幕した。	<企業活動背景>,<日本>,<その他>
世界で脱炭素の機運が高まるなか、日本政府も温暖化ガスの削減目標を打ち出した。	<政府活動>,<日本>,<目標・計画・指針>
富士通の情報共有ツールに外部から不正アクセスがあり外務省や国土交通省などの個人情報が流出した問題で、東京五輪・パラリンピック組織委員会の個人情報も漏れていたことが4日、関係者への取材で分かった。	
組織委のほか、中央省庁、東京都や福島県といった会場となる地方自治体、スポンサー企業を含む約90組織のセキュリティー担当者ら約170人の情報が漏えいした。	
政府が配布する米モデルナ製ワクチンを21日以降に接種する。	
ワクチンの職域接種を開始する政府方針に協力する。	<政府活動>,<日本>,<その他>
政府が職場などでの「職域接種」を可能とする方針を示したことを受けて協力する。	<企業活動背景>,<日本>,<目標・計画・指針>
経済産業省は温暖化ガス排出量の多い業種別に脱炭素に向けた工程表を策定する。	<政府活動>,<日本>,<目標・計画・指針>
米司法省がトランプ前政権下で米紙ニューヨーク・タイムズの記者4人の通話記録を極秘に入手していたことが3日までに分かった。	<政府活動>,<米国>,<その他>
通話記録の入手は米司法省が同紙に連絡を入れ、判明した。	<政府活動>,<米国>,<目標・計画・指針>
政府が2日、職場接種を可能とする方針を示したことを受けた対応。	<企業活動背景>,<日本>,<目標・計画・指針>
新型コロナウイルスのワクチンを職場で接種するよう政府が促していることを受け、九州・沖縄でも主な大手企業が検討を始めた。	<企業活動背景>,<日本>,<法整備・規制>,<検討>
経済産業省が近くまとめるデジタル産業についての新戦略が明らかになった。	<企業活動背景>,<日本>,<その他>
政府が2050年に温暖化ガスの排出を実質ゼロにする方針を掲げたのを受け、脱炭素対策に取り組む企業が増えているのに対応する。	<政府活動>,<日本>,<指数・統計>
原料となる輸入小麦の政府売り渡し価格が引き上げられたことに加え、物流費や包装費なども上昇しているため。	
政府は3日、脱炭素社会の実現に向けた住宅・建築物の対策案を示した。	<政府活動>,<日本>,<目標・計画・指針>
流出したのは、NISCが富士通に開発や運営を委託する情報システムの機器情報のほか、同センターが実施する訓練に参加した政府や企業約90組織、約170人分の役職や氏名といった情報だ。	
ただ政府が出資することで、報道の独立性が大きく揺らぐ懸念も強まる。	<企業活動背景>,<日本>,<補助金・交付金>
新型コロナウイルスのワクチンを職場で接種するよう政府が促していることを受け、関西で検討する企業が増えている。	<企業活動背景>,<日本>,<指数・統計>
資源エネルギー庁が2日発表した5月31日時点のレギュラーガソリンの店頭価格は前週比0.1円値下がりし、1リットル152.5円だった。	<政府活動>,<日本>,<指数・統計>
内閣サイバーセキュリティセンターは2日、富士通の情報共有システムへの不正アクセスに絡み、同センターが実施したサイバーセキュリティーに関する訓練に参加した政府や民間企業約90組織、約170人分の役職、氏名などの個人情報が流出したと発表した。	<政府活動>,<日本>,<その他>
総務省は2日、高速通信規格「5G」の基地局整備が遅れているとして、ソフトバンクを電波法に基づき行政指導した。	<政府活動>,<日本>,<法整備・規制>
総務省は4G用に割り当てた電波の5G転用を認めている。	<政府活動>,<日本>,<法整備・規制>
総務省は21年中に不足分を解消するよう求めた。	<政府活動>,<日本>,<法整備・規制>
政府は2日、月内に決める成長戦略の原案を公表した。	<政府活動>,<日本>,<目標・計画・指針>
香港政府は2050年までに二酸化炭素などの温暖化ガスの排出を実質ゼロにする「カーボンニュートラル」を目指す方針を決めた。	<政府活動>,<香港>,<目標・計画・指針>
--香港政府がカーボンニュートラルの目標を発表しました。	<政府活動>,<香港>,<目標・計画・指針>
政府が新型コロナウイルスのワクチンに関し、高齢者向けの確保にめどがついたとみて12~64歳の一般向け接種に本格的に着手する。	<政府活動>,<日本>,<目標・計画・指針>
米連邦捜査局が捜査に着手し、米農務省は他の加工業者と協議して食肉供給への影響を調べている。	<政府活動>,<米国>,<法整備・規制>,<検討>
政府はトラックなどの小型商用車の新車販売を2040年までに全て電気自動車や燃料電池車といった電動車などに切り替える目標を設ける。	<政府活動>,<日本>,<目標・計画・指針>
北陸電力と富山市は2019年にSDGsについて連携協定を結んでおり、共同でエネルギーの地産地消を推し進め、50年までに温暖化ガス排出量を実質ゼロにする政府の方針に対応する。	<企業活動背景>,<日本>,<目標・計画・指針>
経済産業省は二酸化炭素から都市ガスの原料となるメタンを合成する技術開発を強化する。	<政府活動>,<日本>,<法整備・規制>
政府は1日、国産ワクチンの開発・生産についての国家戦略を閣議で決めた。	<政府活動>,<日本>,<目標・計画・指針>
19年10月の消費増税にあわせた政府のポイント還元事業などを機に日常使いが広がっている。	
日本経済新聞社と総務省は6月7、8日の2日間、この分野の有力企業トップや専門家を国内外から招いて、「ポスト・ニューノーマル~レジリエントな社会を目指して」をテーマに「世界デジタルサミット2021」を開催、ネット配信する。	<政府活動>,<日本>,<国際会議・会合・会談>
政府は1日、ワクチン開発・生産体制を強化する戦略を閣議で決めた。	<政府活動>,<日本>,<目標・計画・指針>
政府は米国で広がった特別買収目的会社「SPAC」の解禁を検討する。	<政府活動>,<日本>,<法整備・規制>
総務省は31日、格安スマートフォン事業者が携帯大手から借りる通話回線の貸出料について、引き下げに向けた制度を整備する方針を示した。	<政府活動>,<日本>,<目標・計画・指針>
産業用素材の過度な高値を警戒する中国政府が立て続けに規制の強化に動いたためだ。	<政府活動>,<中国>,<その他>
2050年に温暖化ガス排出量を実質ゼロにするという政府目標の達成に向け、小さな働き者が切り札になるかもしれない。	
政府は米国で広がった特別買収目的会社「SPAC」の解禁を検討する。	<政府活動>,<日本>,<法整備・規制>
欧州連合で医薬品の審査を担当する欧州医薬品庁は28日、独ビオンテックと米ファイザーが共同開発した新型コロナウイルスワクチンについて、12~15歳への承認を勧告すると発表した。	<政府活動>,<欧州>,<法整備・規制>
欧州委員会が正式に承認したうえで、実際の運用は加盟国の政府がそれぞれ決める。	<政府活動>,<日本>,<法整備・規制>
日本鉄鋼連盟の橋本英二会長は28日記者会見し、政府が2050年に目標を掲げるカーボンニュートラル政策について、「安全が確認された原子力発電設備などを最大限活用する必要がある」と述べた。	<企業活動背景>,<日本>,<目標・計画・指針>
総務省は28日、携帯会社が自社の回線契約でしか端末を使えないようにするSIMロックを巡り、10月1日から原則禁止する方針を示した。	<政府活動>,<日本>,<法整備・規制>
民間人材を活用しながら、県庁内はもとより、県民生活の質向上や産業活性化にもつなげる。	
政府は電気自動車やハイブリッド車向けの急速充電器を2030年をめどに現在の約4倍の3万基まで増やす。	<政府活動>,<日本>,<目標・計画・指針>
総務省は携帯大手が販売代理店に支払う手数料体系などが不適切な営業行為を助長していると判断した場合、携帯大手に業務改善命令を出せるようにする。	<政府活動>,<日本>,<法整備・規制>
実証は政府系のタイ発電公社が中心となり、12月から2022年12月までする予定だ。	
厚生労働省が28日発表した2020年度の毎月勤労統計調査によると、1人あたりの現金給与総額は月平均で31万8081円だった。	<政府活動>,<日本>,<指数・統計>
「米国政府が収益を吸い上げようとしている。税金はグーグルから取るべきで、私たちからではない」。	
総務省が28日、情報通信行政・郵政行政審議会にNTT東西の契約約款の変更認可を諮問する。	<政府活動>,<日本>,<法整備・規制>,<検討>
日本新聞協会は27日、巨大IT企業の規制新法の対象にインターネット広告を加えるとした政府の最終報告への意見書を提出した。	
実態が不透明だと指摘されるネット広告取引の改善に向け、新法が促すIT企業の対応を政府が点検することを通じ、規制に実効性を持たせるよう求めた。	
放送法に基づく外資規制に違反していた企業や、総務省幹部の接待問題が表面化し、野党が審議入りに反発してきた。	
政府が洋上風力の導入を促進する海域に指定する秋田県沖や千葉県沖では、風力発電の開発事業者が参入方針を打ち出している。	<企業活動背景>,<日本>,<目標・計画・指針>
政府は2019年4月、洋上風力の導入を促進する「再エネ海域利用法」を施行した。	<政府活動>,<日本>,<法整備・規制>,<施行>
総務省は5月25日、世界6都市の携帯電話料金などを比較した「電気通信サービスに係る内外価格差調査」の2020年度の調査結果を発表した。	<政府活動>,<日本>,<その他>
新型コロナウイルスの感染拡大が長期化し、政府が5月31日までとする9都道府県の緊急事態宣言は延長が検討されている。	<政府活動>,<日本>,<その他>
経済産業省などは企業が削減した温暖化ガス排出量を売買できる制度の対象に水素活用分を追加する。	<政府活動>,<日本>,<法整備・規制>,<改正>
経産省、環境省、農林水産省が2013年度から始めた国内向け売買制度「J-クレジット」を見直す。	<企業活動背景>,<日本>,<法整備・規制>,<検討>,<改正>
資源エネルギー庁が26日発表した24日時点のレギュラーガソリンの店頭価格は前週比0.8円上昇し、1リットル152.6円だった。	<政府活動>,<日本>,<指数・統計>
富士通が手掛ける情報共有ツールに第三者からの不正アクセスがあり、複数の顧客情報が外部に流出した問題で、新たに内閣サイバーセキュリティセンターや国土交通省の情報も漏れていたことが分かった。	
現在、1キロワットの電力を発生させるのにかかる同装置の製造コストは20万円程度とされるが、2020年代半ばにも政府が目標とする5万円を下回るよう目指す。	<政府活動>,<日本>,<目標・計画・指針>
経済産業省は一定の投資効果を得られたとみて、2022年3月までの期限を延ばすよう、財務省と本格協議に入る。	<政府活動>,<日本>,<目標・計画・指針>
米商務省が25日発表した4月の新築一戸建て住宅販売件数は86万3000戸だった。	<政府活動>,<米国>,<指数・統計>
「2050年までの脱炭素社会の実現」を明記し、50年までに温暖化ガス排出量を実質ゼロにする政府の目標の法的な裏付けとなる。	
農林水産省が25日発表した食品価格動向調査によると、対象の8品目のうちキャベツやレタスなど6品目が平年比で安くなった。	<政府活動>,<日本>,<指数・統計>
経済産業省が25日に開いた使用済み核燃料の貯蔵や処分を検討する対策推進協議会で報告した。	<政府活動>,<日本>,<法整備・規制>
近く政府に提出し、政府が今夏に改めるエネルギー基本計画への反映を要求する。	<政府活動>,<日本>,<法整備・規制>,<施行>
厚生労働省の部会は同新薬の製造販売を認める方針を明らかにした。	<政府活動>,<日本>,<法整備・規制>
総務省は25日、東京など世界6都市の2021年3月時点の携帯電話料金に関する調査結果を発表した。	<政府活動>,<日本>,<その他>
消費者庁は25日、NTTドコモ、KDDI、ソフトバンクの携帯大手3社を行政指導したと発表した。	<政府活動>,<日本>,<法整備・規制>
総務省はのべ38件と公表しており、新たな接待疑惑が判明したことになる。	<企業活動背景>,<日本>,<その他>
板金加工や省力化機器製造のDAISEは金箔など金属箔の裁断加工を支援する機械を2021年秋にも商品化する。	
経済産業省が14日、電気事業法に基づく使用前検査で合格とした。	<政府活動>,<日本>,<法整備・規制>
政府が輸入小麦の売り渡し価格を引き上げたことに対応する。	<政府活動>,<日本>,<指数・統計>
同社は2050年までに二酸化炭素排出量を実質ゼロにする政府の方針に対応し、再生可能エネルギーの量を増やしている。	<企業活動背景>,<日本>,<目標・計画・指針>
中国政府は食の安全保障の観点から遺伝子組み換え作物の普及を後押しし、大手2社に作付け認可の手前にあたる安全認証を出した。	<政府活動>,<中国>,<その他>
成長率が最も高い業種は教育、、で、政府官公庁・地方自治体、、、電力・ガス・水道、が続いた。	
厚生労働省がインド型の変異ウイルスの監視強化を都道府県などに通知したことを受け、検査機関から早期出荷を要望する声があった。	<企業活動背景>,<日本>,<法整備・規制>
エチオピア政府が、住友商事と英ボーダフォングループなどの企業連合体の携帯通信事業への参入を認めた。	<政府活動>,<エチオピア>,<法整備・規制>
先端技術で地域活性化などを目指す政府の「スーパーシティ」構想に応募した前橋市は独自の携帯通信網「まえばしモバイル」を整備する計画を盛り込んだ。	
実現すれば全国初となるプランの背景には、小中学生に1人1台のパソコンなどを配備する政府の「GIGAスクール構想」があった。	
長時間にわたって同じ地域を大雨が襲う「線状降水帯」の発生を呼びかける取り組みを、気象庁が6月中旬に始める。	<政府活動>,<日本>,<その他>
韓国政府が21日に発表した同国企業の対米投資計画の最大の目玉は、サムスンの半導体新工場の建設だ。	<企業活動背景>,<韓国>,<その他>
これら2社にサムスンを加えた「半導体ビッグ3」による対米投資が出そろい、米政府が目指す国内生産回帰に弾みがつく。	<企業活動背景>,<米国>,<その他>
韓国政府は21日、韓国の主要企業が計4兆円規模の投資を米国で実行すると発表した。	<政府活動>,<韓国>,<その他>
韓国の文在寅大統領の訪米に合わせて米商務省が開いた両国の政府関係者、企業経営者らが参加する会議で表明した。	<企業活動背景>,<米国>,<その他>
欧州連合で医薬品の審査を担当する欧州医薬品庁は21日、英製薬大手アストラゼネカの新型コロナウイルスワクチンについて、1回目の接種で血小板減少を伴う血栓を発症した人には2回目の同ワクチンの接種をしてはならないと勧告した。	<政府活動>,<欧州>,<法整備・規制>
政府は東京、兵庫、北海道などを対象とする緊急事態宣言を5月末まで延長し、沖縄も追加することを決めた。	<政府活動>,<日本>,<法整備・規制>,<改正>
厚労省は再発防止や法令順守、役職員に対する教育を含めた組織体制の構築などを命じた。	<政府活動>,<日本>,<法整備・規制>
制度の説明を受けた英国政府幹部が語った。	<政府活動>,<英国>,<その他>
経産省も3月に半導体戦略の骨子をまとめた。	<政府活動>,<日本>,<目標・計画・指針>
総務省が21日発表した4月の消費者物価指数によると、変動の大きい生鮮食品を除く総合指数は101.5と前年同月比0.1%下がった。	<政府活動>,<日本>,<指数・統計>
まず米中央情報局などの情報機関を束ねる政府の機関に気候変動の影響を調査するように指示した。	
中国政府が大手ネット企業への締め付けを強めるなか、これまで築いてきた優位性を保てるかが今後の焦点になる。	<企業活動背景>,<中国>,<その他>
経済産業省は「空飛ぶクルマ」の2030年代の本格導入に向けた運航ルールなど法整備の検討に入った。	<政府活動>,<日本>,<法整備・規制>,<検討>
新たに設ける作業部会は経産省と万博運営主体の日本国際博覧会協会が事務局を担う。	<政府活動>,<日本>,<法整備・規制>
アルゼンチン政府がインフレ対策として牛肉の輸出を禁止し、経済界と激しく対立している。	<企業活動背景>,<アルゼンチン>,<法整備・規制>
厚生労働省は20日、米モデルナ製と英アストラゼネカ製の新型コロナウイルスワクチンについて製造販売の特例承認を薬事・食品衛生審議会の専門部会で審議する。	<政府活動>,<日本>,<法整備・規制>,<検討>
農林水産省が発表した4月の2020年産米の相対取引価格は全銘柄平均で前年同月に比べて7%安い1俵1万4732円だった。	<政府活動>,<日本>,<指数・統計>
「主要国・地域の補助金に比肩する支援を、日本の半導体産業も必要としている」と言及し、競争力強化に向けた政府支援を求めた。	
政府や国際社会が求める二酸化炭素排出量の削減で、カギを握る脱炭素燃料の調達で海外に依存し、国内サプライチェーンの構築が遅れているためだ。	<企業活動背景>,<日本>,<法整備・規制>
自民党のルール形成戦略議員連盟は、経済安全保障を巡り政府と経済団体が話し合う協議会の創設を求める提言を近くまとめる。	<政府活動>,<日本>,<法整備・規制>
総務省は19日、格安スマートフォン事業者に対する携帯電話番号の直接割り当てに向けた議論を始めた。	<政府活動>,<日本>,<国際会議・会合・会談>
総務省は番号の割り当て要件の一つに携帯基地局の無線免許を持つことを告示で定めている。	<政府活動>,<日本>,<その他>
原料となる輸入小麦の政府売り渡し価格が引き上げられたことに加え、物流費や包装費なども上昇しているため。	
ドイツの独禁法当局である連邦カルテル庁は18日、米アマゾン・ドット・コムに対する新たな調査を始めたと発表した。	<政府活動>,<日本>,<その他>
連邦カルテル庁のアンドレアス・ムント長官は声明で「まず、アマゾンが様々な市場にまたがって挑戦されることのない力を持つかを調べる。そのような地位を有していると判断した場合、アマゾンが行う可能性のある反競争的行為を禁止できる」と述べた。	<政府活動>,<日本>,<法整備・規制>
総務省は、格安スマートフォン事業者に電話番号を直接割り当てる方針だ。	<政府活動>,<日本>,<目標・計画・指針>
スズキは工業用酸素を医療用に回す政府の指示などで止めていた工場を17日に再開。	
インド政府が新型コロナウイルス対策として20年に実施したロックダウンの影響が響いた。	
経済産業省は18日、脱炭素技術の普及などを支援する2兆円の基金のうち、水素関連の2事業について企業の公募を開始したと発表した。	<政府活動>,<日本>,<補助金・交付金>
同社は「欧州の多くの政府が調整や事前通告もなく、フライトの禁止や旅行制限を課した。常に変化する政府の指針や制限が、乗客や従業員に混乱と不確実性をもたらした」とコメントした。	
オーストラリア政府は17日、国内の製油所に対して最大で約24億豪ドルの支援を行うと発表した。	<政府活動>,<オーストラリア>,<補助金・交付金>
新型コロナウイルスの感染拡大で政府が3度目の緊急事態宣言を発令。	<政府活動>,<日本>,<法整備・規制>
太陽光や風力など再生可能エネルギーの企業の利用を促すため、経済産業省は新たな調達の仕組みをつくる。	<政府活動>,<日本>,<その他>
新型コロナウイルスの感染拡大を受け政府は企業に出勤者の7割削減を求め、経済産業省や関西経済連合会は企業に対し取り組みの公表を促していた。	<政府活動>,<日本>,<法整備・規制>
政府は新型コロナウイルス感染が急拡大している北海道を緊急事態宣言の対象地域に追加する。	<政府活動>,<日本>,<法整備・規制>,<改正>
新型コロナウイルスのワクチンについて、厚生労働省は米モデルナ製と英アストラゼネカ製の承認の可否を近く判断する方向だ。	<政府活動>,<日本>,<法整備・規制>,<検討>,<施行>
住友商事は14日、6月の株主総会で環境系非政府組織が提出した気候変動の事業戦略策定・開示へ定款変更を求める株主提案に対し、反対すると発表した。	
経済産業省は2030年度の実現を目指す新たな電源構成の比率について、原子力や再生可能エネルギーなど発電時に二酸化炭素を排出しない脱炭素電源を6割を視野に引き上げる方針だ。	<政府活動>,<日本>,<目標・計画・指針>
政府は燃料電池車の検査を簡素化する検討に入った。	<政府活動>,<日本>,<法整備・規制>,<検討>
経済産業省の有識者会議が6月にまとめる中間答申に盛り込む。	<政府活動>,<日本>,<法整備・規制>
新型コロナウイルス感染拡大を受けて政府や自治体が行う支援策が支えになっており、4月としては過去30年間で最少だった。	<企業活動背景>,<日本>,<指数・統計>
政府は4月22日、地球温暖化対策推進本部で2030年までの温暖化ガス削減目標を46%に引き上げ「さらに50%の高みに向けて挑戦を続ける」ことを決定し、菅義偉首相は同日に開催された米国主催の気候変動に関する首脳会議に臨んだ。	<政府活動>,<日本>,<法整備・規制>
中国政府が自動車の走行データなどの統制に乗り出す。	<政府活動>,<中国>,<その他>
金融庁と東京証券取引所は、環境に配慮したグリーンボンドへの投資環境を整備する。	<政府活動>,<日本>,<その他>
経済産業省は送電網を利用する際の料金を、2023年4月から発電事業者にも負担を求める。	<政府活動>,<日本>,<法整備・規制>
政府が打ち出した2050年の温暖化ガス排出実質ゼロの目標達成に向け、東北電力も脱炭素に向けた課題を突きつけられている。	<企業活動背景>,<日本>,<目標・計画・指針>
この総会では、経済産業省の元参与が一部株主に対して議決権を行使しないよう圧力をかけたとの疑いが指摘されている。	
経産省側は質疑で「元参与に対し、投資家への働きかけを依頼したことはない」として関与を否定した。	<政府活動>,<日本>,<その他>
トヨタ自動車の豊田章男社長は、会長を務める日本自動車工業会の最近の記者会見で、日本のエネルギー政策や「脱エンジン」に傾く政府関係者の動きに不満をにじませている。	
国税庁とNTTデータは金融機関への問い合わせ業務の電子化で連携する。	<政府活動>,<日本>,<その他>
米政府は供給の混乱を避けるため、消費者に買いだめを控えるよう呼びかけている。	<政府活動>,<米国>,<目標・計画・指針>
11日にはカナダ政府が「エネルギー安全保障に不可欠だ」として閉鎖に反対する準備書面を米連邦裁判所に提出した。	<政府活動>,<カナダ>,<法整備・規制>,<施行>
宮城県は11日、政府が東京電力福島第1原子力発電所の処理水の海洋放出を決定したことを受け、関係団体の意見を集約する連携会議の初会合を開いた。	<政府活動>,<日本>,<国際会議・会合・会談>
政府が7月末の完了をめざす高齢者向け接種を円滑に進める体制づくりが急務だ。	<企業活動背景>,<日本>,<その他>
政府は温暖化ガス削減に向けて再生可能エネルギーの拡大を掲げている。	<政府活動>,<日本>,<目標・計画・指針>
中国政府や企業がコールドチェーンの整備を急いでいる。	<政府活動>,<中国>,<目標・計画・指針>
米運輸省高速道路交通安全局は10日、ホンダの中型セダン「アコード」のステアリング装置に不具合の可能性があり調査を始めたと発表した。	<政府活動>,<米国>,<その他>
農林水産省がまとめた3月の米穀販売事業者のコメ販売数量は2020年3月比で8.9%減った。	<政府活動>,<日本>,<指数・統計>
日本政府が2050年までのカーボンニュートラルを掲げる中、水素の実用性を検証する。	<企業活動背景>,<日本>,<その他>
新型コロナウイルスの感染拡大に伴う政府の緊急事態宣言の延長に伴い、観光施設やカラオケ店で休業や営業時間の短縮といった方針決定が相次いでいる。	
政府は2030年度に温暖化ガスの排出量を13年度比で46%減らす方針を打ち出した。	<政府活動>,<日本>,<目標・計画・指針>
農業の脱炭素化に向け、農林水産省が近くまとめる農機などの開発の工程表が明らかになった。	<政府活動>,<日本>,<その他>
政府が30年度の温暖化ガス排出量の削減目標を13年度比46%減へと引き上げたことを受け、対策を急ぐ。	<企業活動背景>,<日本>,<指数・統計>
一方でインド政府が抗ウイルス薬「レムデシビル」を輸出規制するなど、国際分業の課題も見えてきた。	<企業活動背景>,<インド>,<法整備・規制>
英政府は日立に対し、亀裂の状態を確認し、車両が安全に運行できるかどうかなどの調査と報告を求めた。	<政府活動>,<英国>,<法整備・規制>
政府は時短での営業再開を容認したが自治体により対応は分かれており、地域で難しい事業運営が続いている。	<企業活動背景>,<日本>,<法整備・規制>
大型商業施設への休業要請を巡り、政府と自治体の方針が割れたのを受けて、百貨店業界には戸惑いとともに自治体の方針に従わざるをえないとの見方が広がった。	<企業活動背景>,<日本>,<その他>
11日を期限とする緊急事態宣言の延長にあたり、政府は百貨店など大型商業施設への休業要請を緩和し、午後8時までの時短営業とする方針を示した。	<政府活動>,<日本>,<目標・計画・指針>
人権侵害の疑いが強いとして法務省が削除要請した件数は過去最多になったが、企業が応じたのは7割未満。	<政府活動>,<日本>,<指数・統計>
日本製鉄の橋本英二社長は7日、政府が打ち出した温暖化ガス排出量を2030年度に13年度比で46%削減する目標について「電力も産業も家庭も全て一律で46%減とは承知していない」との認識を示した。	<企業活動背景>,<日本>,<その他>
橋本社長は「現実を預かる立場としては「46%減」と無責任なことは言えない」として、政府目標の達成は簡単ではないと説明したうえで「確実に、一日でも早く前倒しできるかということになる」と述べるにとどめた。	
新型コロナウイルス感染拡大の長期化を受け、政府は7日、大阪府など4都府県を対象に11日を期限としていた緊急事態宣言の期間を31日まで延長すると決めた。	<政府活動>,<日本>,<法整備・規制>,<改正>
政府が2050年に温暖化ガス排出量を実質ゼロにする方針を掲げたことを受け、再生可能エネルギーの需要拡大を見込んで建設する。	<企業活動背景>,<日本>,<目標・計画・指針>
国土交通省東京航空局がまとめた。	<政府活動>,<日本>,<その他>
政府は緊急事態宣言に準じた対策を可能にする「まん延防止等重点措置」の適用対象に北海道を追加する。	<政府活動>,<日本>,<法整備・規制>,<改正>
米バイオ製薬モデルナのステファン・バンセル最高経営責任者は6日、バイデン米政府が新型コロナウイルスワクチンの特許の一時放棄を支持したことについて「特許を放棄しても供給量は増えない」と反論した。	<企業活動背景>,<米国>,<指数・統計>
居酒屋「金の蔵」を運営する三光マーケティングフーズは7日、政府が緊急事態宣言を延長する方針を固めたことを受け、宣言下の地域にある金の蔵などの直営店の休業を31日まで延長することを決めた。	<企業活動背景>,<日本>,<法整備・規制>,<改正>
政府が4月23日に3度目の緊急事態宣言を出したことも背景に19年比では全方面で旅客が減った。	<政府活動>,<日本>,<指数・統計>
50年のカーボンニュートラルを目指す政府に対し、自社内では前倒しの達成を目指す。	
政府が緊急事態宣言を延長しても営業再開に踏み出したい考えだ。	<政府活動>,<日本>,<法整備・規制>,<改正>
国内外の通信・コンテンツ事業者や総務省が2021年度中に連携の体制を整える。	
2020年4月に新型コロナウイルスの感染拡大を受け政府が1度目の緊急事態宣言を発令し、販売が落ち込んだ反動で増加幅が大きくなった。	<企業活動背景>,<日本>,<法整備・規制>
この人が会長ポストを引き受けてくれたことに経済産業省はホッと一息ついているだろう。	
金融庁と東京証券取引所は6月に施行する上場企業への「コーポレートガバナンス・コード」に人権を尊重するよう求める規定を盛り込む。	<政府活動>,<日本>,<法整備・規制>
政府は産業界と組み、情報処理や通信に使う量子技術の共同研究に乗り出す。	<政府活動>,<日本>,<その他>
米政府は人権保護や安全保障の観点から、ドローン世界最大手の中国DJIに対する事実上の禁輸措置を発動した。	<政府活動>,<米国>,<法整備・規制>,<施行>
消費者庁は3日までに、イオンのプライベートブランド「トップバリュ」のロゴを盗用するなどした偽の通販サイトが5件確認されたと明らかにした。	<政府活動>,<日本>,<その他>
同庁は「新型コロナウイルス禍の巣ごもり需要でインターネット通販が増加している。サイトの運営者情報をよく確認して」と注意を呼び掛けている。	<政府活動>,<日本>,<指数・統計>
米政府が主催した気候変動に関する首脳会議と相前後し、企業からも精力的な取り組みが表明されている。	<企業活動背景>,<米国>,<その他>
菅義偉首相の指示を受け、2月から環境省と経済産業省がそれぞれ有識者会議を設けて議論を始めた。	<政府活動>,<日本>,<国際会議・会合・会談>
政府が新たな温暖化ガス削減目標を打ち出したのを受け、自動車産業への脱エンジン圧力が強まっている。	<企業活動背景>,<日本>,<その他>
政府は、日本企業による水素やアンモニアなどの生産を促すため資金支援に乗り出す。	<政府活動>,<日本>,<補助金・交付金>
各国政府は監視を強め、企業も広告手法の見直しに動く。	<企業活動背景>,<日本>,<目標・計画・指針>
日本政府が30年度時点の温暖化ガス排出削減目標を引き上げたのに応じ、最重要分野の一つである電力で脱炭素の取り組みを加速する。	<企業活動背景>,<日本>,<目標・計画・指針>
日本政府が2030年度の温暖化ガス排出量を、13年度比で46%削減する目標を掲げた。	<政府活動>,<日本>,<目標・計画・指針>
特許庁は30日、特許出願に関する調査結果を公表した。	<政府活動>,<日本>,<その他>
政府が新たに設けた支援策を活用して、悪化した財務基盤を強化する。	<政府活動>,<日本>,<法整備・規制>
インド政府は工業用酸素を医療用に回す指示なども出しており、製造業の操業に影響が広がっている。	<企業活動背景>,<インド>,<その他>
政府は29日付で2021年春の叙勲受章者を発表した。	<政府活動>,<日本>,<その他>
政府は環境債に次ぐ資金調達手段として、環境対策を強める企業を支援する「移行債」の市場整備に乗り出す。	<政府活動>,<日本>,<補助金・交付金>
政府が打ち出した「脱炭素」の方針に沿い、再エネの主力電源化に向けた動きを加速する。	<企業活動背景>,<日本>,<目標・計画・指針>
日本自動車工業会は28日、経済産業省と国土交通省が同日開いたカーボンニュートラルに向けた自動車政策検討会の中で、車両の電動化に関わる政府目標に同意する考えを示した。	<企業活動背景>,<日本>,<法整備・規制>,<検討>
総務省の行政指導も受け、今後は親会社のZホールディングスとともに、法令順守と企業統治の両面から経営のあり方が問われそうだが、8600万人いるとされる個人利用者の数はこの間、大きく減ることがなかったという。	
ロシア独占禁止庁は27日、優越的地位を乱用したとして、米アップルに9億600万ルーブルの罰金を科すと発表した。	<政府活動>,<ロシア>,<法整備・規制>
独占禁止庁はロシアのカスペルスキー研究所から、アップルが優越的地位を悪用しているとの申し立てを受けて調査していた。	<政府活動>,<日本>,<その他>
ただ、この方針には経済産業省が難色を示す。	<政府活動>,<日本>,<目標・計画・指針>
国策の処分場政策をめぐる経産省のご都合主義が早くも露呈している。	
政府が東京など4都府県に緊急事態宣言を発令した23日、居酒屋「金の蔵」などを運営する三光マーケティングフーズ社長の長沢成博は危機感をあらわにした。	<企業活動背景>,<日本>,<法整備・規制>
政府は宣言が発令された地域で酒類を提供する飲食店に休業を要請している。	<政府活動>,<日本>,<法整備・規制>
監査・税務・コンサルティングのKPMGジャパンは27日、5月1日付で遠藤俊英前金融庁長官がシニアアドバイザーに就任すると発表した。	
農林水産省が27日発表した食品価格動向調査は、調査対象の8品目のうちバレイショとネギの高値が目立った。	<政府活動>,<日本>,<指数・統計>
農林水産省がまとめた3月末の国産針葉樹合板の在庫は11万3879立方メートルだった。	<政府活動>,<日本>,<指数・統計>
政府が脱炭素の目標を大幅に引き上げたこともあり、温暖化ガスの排出量が多い石炭火力の新設計画はこれでゼロになった。	<企業活動背景>,<日本>,<目標・計画・指針>
政府は大学からの技術流出を防ぐ対策を強化する。	<政府活動>,<日本>,<法整備・規制>
政府の統合イノベーション戦略推進会議が27日の会合で決めた。	<政府活動>,<日本>,<目標・計画・指針>
新型コロナウイルス対策でインド政府が20年3月から全土でロックダウンを行い、販売が苦戦した。	<企業活動背景>,<インド>,<法整備・規制>,<施行>
1日あたりの感染者が32万人を超えるインドで流行する新型コロナウイルスの変異型「インド型」について、日本政府は警戒を強めている。	<政府活動>,<日本>,<指数・統計>
国土交通省がトラックの新しい標準的運賃表を示してから1年が経過した。	<企業活動背景>,<日本>,<目標・計画・指針>
新型コロナウイルスの感染が再拡大し、政府が3度目の緊急事態宣言を発令したことを受けて需要が落ち込むと判断した。	<企業活動背景>,<日本>,<法整備・規制>,<検討>
フィリピン政府が、法人税の減税を柱とした新法を通じて外国企業に投資を呼びかけている。	<政府活動>,<フィリピン>,<その他>
官公庁の高速道路工事や、再開発事業が底上げした。	
官公庁受注は高速道路や病院などで24.8%増えた。	<政府活動>,<日本>,<指数・統計>
政府は27日、米グーグルなどネット広告大手に対し、情報開示の義務づけを柱とした報告書を公表した。	<政府活動>,<日本>,<その他>
対話アプリのLINEの利用者の個人情報に中国からアクセスできた問題を受け、総務省は27日、電気通信事業者のデータ管理体制を検証する有識者会議を設置すると発表した。	<政府活動>,<日本>,<その他>
新型コロナウイルスの感染再拡大に伴い、政府が3度目の緊急事態宣言を発令したことを受けた。	<企業活動背景>,<日本>,<法整備・規制>
より踏み込んだ省力化を実現する製品で顧客を開拓する。	
金融庁と東京証券取引所が上場企業の経営統治の指針となるコーポレートガバナンス・コードを6月にも改定する。	<政府活動>,<日本>,<法整備・規制>,<改正>
人同士の接触を避けられるため、新型コロナウイルスの感染拡大防止策として政府が企業に導入を促す。	<政府活動>,<日本>,<目標・計画・指針>
田辺三菱製薬はカナダ子会社のメディカゴが開発中の新型コロナウイルスワクチンについて、カナダ保健省が製造販売承認の審査を始めたと発表した。	<政府活動>,<カナダ>,<法整備・規制>,<検討>
カナダ保健省は早期承認に向けた制度を適用し、同社が提出したデータの審査を始めた。	<政府活動>,<カナダ>,<法整備・規制>,<検討>,<施行>
コロナ禍で政府が東京、大阪、兵庫、京都を対象とする緊急事態宣言を発令し、大型連休明けの輸送需要が全国的に再び鈍る見通しとなったためとみられる。	<企業活動背景>,<日本>,<法整備・規制>
坂本雅和デジタル化統括監は「県庁内が一体となり、まずは小さくても成果を出していけるよう取り組みたい」と強調した。	
対話アプリのLINEの利用者の個人情報を中国の関連会社から閲覧できた問題で、総務省は26日、電気通信事業法に基づきLINEを行政指導したと発表した。	<政府活動>,<日本>,<法整備・規制>
総務省は26日、携帯販売代理店の従業員の4割が「ニーズや意向を丁寧に確認せず上位の料金プランを勧誘したことがある」と回答したとの調査結果を公表した。	<政府活動>,<日本>,<その他>
通信大手の営業目標を満たすことで代理店が手数料を得る体系が、高い料金プランを顧客に提案する一因だと同省はみている。	<政府活動>,<日本>,<目標・計画・指針>
政府が新型コロナウイルスの緊急事態宣言を東京など4都府県に発令し、石川県も飲食店への時短要請を決めた。	<政府活動>,<日本>,<法整備・規制>
対話アプリのLINEが利用者の個人情報などを中国の関連会社で閲覧できる状態にしていた問題で、総務省は26日、電気通信事業法に基づき同社を行政指導する方針を固めた。	<政府活動>,<日本>,<法整備・規制>
LINEに対して、総務省は個人情報や通信の秘密の保護に支障がなかったかなどについて19日までに報告するよう求めていた。	<政府活動>,<日本>,<法整備・規制>
政府の個人情報保護委員会も23日に行政指導している。	<政府活動>,<日本>,<法整備・規制>
そのために排出量を30年までに13年度比46%減とすることで落ち着いたが、目標を巡る省庁間の温度差は目立つ。	
大企業の社員が立ち上げる会社に経済産業省が補助金をつけ「出戻り」も認める仕組みでは、「出向起業家」も誕生してきた。	<企業活動背景>,<日本>,<法整備・規制>
見据えるのは政府も2050年の目標に掲げる温暖化ガス排出実質ゼロの社会だ。	<政府活動>,<日本>,<目標・計画・指針>
政府は温暖化ガスの排出量を30年度に13年度比46%減らす目標を打ち出した。	<政府活動>,<日本>,<目標・計画・指針>
政府が新型コロナウイルスの緊急事態宣言を東京など4都府県に発令したことを受け、サンリオエンターテイメントは同日、運営する「サンリオピューロランド」を4月25日~5月11日まで臨時休業すると発表した。	<企業活動背景>,<日本>,<法整備・規制>
政府が東京や大阪、兵庫、京都の4都府県に25日から5月11日までを期間として緊急事態宣言を発令したことを受け、旅行各社は対象エリアを発着するツアーの中止などに乗り出す。	<企業活動背景>,<日本>,<法整備・規制>,<廃止>
政府が東京、大阪、京都、兵庫の4都府県に緊急事態宣言を発令したことをうけ、商業施設が対応を急いでいる。	<企業活動背景>,<日本>,<法整備・規制>
三菱地所は24日、政府が緊急事態宣言を発令したことや自治体の要請を受け、丸の内ビルディングなどの自社ビルでレストランや物販店などが入る商業エリアを休業することを決めた。	<企業活動背景>,<日本>,<法整備・規制>
警察庁は6月28日にも道路交通法施行令を改正する。	<政府活動>,<日本>,<法整備・規制>,<改正>
新型コロナウイルスの感染拡大で政府は23日、大阪、兵庫、京都を含む4都府県を対象に緊急事態宣言を発令した。	<政府活動>,<日本>,<法整備・規制>
背景には中央政府が掲げる2060年に二酸化炭素排出量実質ゼロの目標がある。	<企業活動背景>,<日本>,<その他>
経済産業省は23日、今後の資源・燃料政策の方向性について報告書案をまとめた。	<政府活動>,<日本>,<法整備・規制>,<検討>
政府が新型コロナウイルス感染者の急増する東京都、大阪府、兵庫県、京都府を対象に3度目の緊急事態宣言に踏み切る方針を決め、北海道でもホテルの予約キャンセルが出始めた。	<企業活動背景>,<日本>,<目標・計画・指針>
LINEの利用者の個人情報を中国の関連会社が閲覧できた問題で、政府の個人情報保護委員会は23日、LINEに行政指導したと発表した。	<政府活動>,<中国>,<法整備・規制>
政府は2030年度の新しい電源構成について、発電量に占める「脱炭素電源」の割合を当初想定の40%台から過半に引き上げる。	<政府活動>,<日本>,<目標・計画・指針>
働き方改革として、政府は70%以上の有給取得率を目標とする。	<政府活動>,<日本>,<目標・計画・指針>
スターバックスコーヒージャパンは23日、政府が東京都など4都府県に緊急事態宣言を発令することを受け、対象地域約600店舗の営業時間を持ち帰りやデリバリーを含めて当面午後8時までとする方針を明らかにした。	<企業活動背景>,<日本>,<法整備・規制>
政府は22日、新型コロナウイルス感染拡大に伴う緊急事態宣言を東京、大阪、京都、兵庫の4都府県に発令すると決め、酒類を提供する店に期間中の休業を要請する見込みだ。	<政府活動>,<日本>,<法整備・規制>
同日に警察庁がヘルメット無しの公道走行を実証実験として認めたことを受け、スタートアップのLuupが渋谷区など都内6区でサービスを始めた。	<企業活動背景>,<日本>,<法整備・規制>
サイゼリヤは23日、政府が東京都など4都府県に緊急事態宣言を発令する見通しになったことを受け、対象地域で酒類の提供を中止する方針を明らかにした。	<企業活動背景>,<日本>,<法整備・規制>,<廃止>
政府は酒類を提供する飲食店に休業要請を出す見通し。	<政府活動>,<日本>,<その他>
政府が2030年度時点の温暖化ガスの排出削減目標を7割以上、引き上げた。	<政府活動>,<日本>,<目標・計画・指針>
居酒屋「金の蔵」を運営する三光マーケティングフーズは23日、政府が同日にも東京都など4都府県で緊急事態宣言を発令する意向を受け、対象地域で居酒屋業態店を宣言期間中に休業すると明らかにした。	<企業活動背景>,<日本>,<法整備・規制>
政府は国営企業の保護を重視し、民間のビジネス環境の悪化につながる施策を相次いで導入している。	<政府活動>,<日本>,<法整備・規制>,<施行>
政府が鉱石の輸出禁止に踏み切ったことも企業を現地生産に引き寄せる。	<企業活動背景>,<日本>,<目標・計画・指針>
国連気候変動に関する政府間パネルは50年に温暖化ガスの排出量を実質ゼロにすることで1.5度目標を達成できるとしている。	<政府活動>,<日本>,<目標・計画・指針>
国土交通省関東地方整備局はデジタル技術で変革を起こす「デジタルトランスフォーメーション」を公共事業の分野で推進しようと、千葉県松戸市に3Dや遠隔操作を用いた建設技術を学べる人材育成センターを開設した。	<政府活動>,<日本>,<目標・計画・指針>
LINEの利用者の個人情報が閲覧できた問題で、政府の個人情報保護委員会は22日、同社に近く行政指導する方針を固めた。	<政府活動>,<日本>,<目標・計画・指針>
経済産業省の幹部は今の東電HDの会長職をこう評する。	<政府活動>,<日本>,<その他>
東京電力ホールディングスが会長兼取締役会議長に、三菱ケミカルホールディングス会長の小林喜光氏を招く方向で政府と最終調整に入ったことが、22日分かった。	<政府活動>,<日本>,<その他>
政府は2030年度の新しい温暖化ガスの削減目標について、13年度と比べて46%減とする方向で調整に入った。	<政府活動>,<日本>,<その他>
あらゆるモノがネットにつながる「IoT」機能により家電の消費電力が増え、電子部品にも省エネ機能が求められている。	
政府が4~5月に全面公開する全国の3次元デジタル地図プラットフォームから新ビジネスが生まれている。	
昨年12月に政府がいったん承認を見送っていたが、条件を変えて再度実施し実用化を目指す。	<政府活動>,<日本>,<法整備・規制>,<検討>
40年超原発について、福井県議会は19日にも全員協議会を開催して、関西電力、国、原子力規制庁などに対して質疑、21日は知事と各会派の代表者らとの討論が開催された。	<政府活動>,<日本>,<国際会議・会合・会談>
新型コロナ薬として承認を得るため2020年3月末~9月半ばにも実施したが、政府が20年12月に有効性の判断が難しいとして承認を見送った。	<政府活動>,<日本>,<法整備・規制>
産学官での連携により、政府が教育のデジタル化を目指す「GIGAスクール構想」を推進する。	<企業活動背景>,<日本>,<目標・計画・指針>
資源エネルギー庁が21日発表した19日時点のレギュラーガソリンの店頭価格は、前週比横ばいの1リットル150.4円だった。	<政府活動>,<日本>,<指数・統計>
経済産業省は工場などで排出した二酸化炭素を回収し、水素と反応させてつくる「合成燃料」を2040年までに商用化する。	<政府活動>,<日本>,<その他>
国土交通省出身の洞駿社長は留任する。	
欧州連合の医薬品規制当局である欧州医薬品庁は20日、米日用品・製薬大手ジョンソン・エンド・ジョンソンの新型コロナウイルスワクチンについて、ごくまれな血栓の症例と関連している可能性があると発表した。	<政府活動>,<欧州>,<その他>
政府は老朽化した企業の基幹システムを刷新する機会としたい考えだ。	<政府活動>,<日本>,<その他>
人工知能などで住みやすい都市を実現する政府の「スーパーシティ」構想で、前橋市は小学校から大学までの一貫校を市内に設置する計画を盛り込んだ。	
中国政府が5年後に年500万台をめざす世界最大のEV市場を舞台に世界大手の主導権争いが本格化する。	
進出予定先の州政府は19日、工場の建設が今も進んでいないとし、40億ドルの税優遇措置を実行しないと発表した。	<政府活動>,<米国>,<税制・予算>
同工場は約束した雇用を創出しておらず、州政府は当初計画を前提とする契約の見直しを求めていた。	<政府活動>,<米国>,<法整備・規制>
ウィスコンシン州政府が19日、フォックスコンと税優遇契約の見直しで大筋合意したと発表した。	<政府活動>,<米国>,<税制・予算>
東京電力の小早川智明社長は20日、茨城県庁を訪れ、福島第1原発の処理水を海洋放出する政府決定を受けた対応方針を大井川和彦知事に説明した。	
宇宙航空研究開発機構に対するサイバー攻撃に関与したとして、警視庁公安部が20日、中国共産党員でシステムエンジニアの30代の男を私電磁的記録不正作出・同供用の疑いで書類送検した。	<政府活動>,<日本>,<法整備・規制>
総務省は2030年代の実用化に向け、国内外の企業の連携などを支援する。	<政府活動>,<日本>,<補助金・交付金>
英政府は19日、米半導体大手エヌビディアによる英半導体設計大手アームの買収について、安全保障上の問題が無いか調査すると発表した。	<政府活動>,<英国>,<その他>
英国の競争当局である競争・市場庁は、買収が市場競争上問題ないか調べている。	<政府活動>,<日本>,<その他>
アーム設計の半導体が世界で幅広く使われていることなどから、英政府は安保面でも精査することを決めた。	<政府活動>,<英国>,<法整備・規制>,<検討>
英政府はCMAに対し、7月30日までに競争面や安保面などでの影響を報告するよう求めた。	<政府活動>,<英国>,<法整備・規制>
中国政府は鋼材市況の安定のためにも過剰能力の削減を求めており、統合により設備の統廃合にも対応しやすくする。	<政府活動>,<中国>,<法整備・規制>
同省が電気通信事業法に基づき、同日までの報告を要請していた。	<政府活動>,<日本>,<法整備・規制>
同省や個人情報保護委員会が行政処分を下すかが今後の焦点になる。	
総務省はLINEに対して問題発生の経緯、個人情報と通信の秘密が適切に保護されていたかなど計5項目の報告を求めていた。	<政府活動>,<日本>,<法整備・規制>
農林水産省が発表した2020年産米の相対取引価格は全銘柄平均で前年同月に比べて6%安い1俵1万4740円だった。	<政府活動>,<日本>,<指数・統計>
総務省は19日、電波の有効利用を検討する有識者会議で、特定の携帯会社などが占有する周波数帯を再配分する仕組みを整備する方針を示した。	<政府活動>,<日本>,<目標・計画・指針>
これを受け、温暖化ガス排出量や燃料使用量、騒音が少ない「グリーンな航空」に対する英政府のコミットメントへの懸念が浮上している。	
日本政府が東京電力福島第1原子力発電所の汚染水を浄化した「処理水」を海洋放出する方針を決めたことに韓国が猛反発している。	<企業活動背景>,<韓国>,<目標・計画・指針>
科学的根拠に乏しい強硬対応の背景には、政府が何もしてこなかったとの批判をかわす狙いが透ける。	
厚生労働省が16日に発表した、新型コロナウイルス対策の接触確認アプリ「COCOA」の長期不具合に関する報告書の要旨は以下の通り。	<政府活動>,<日本>,<目標・計画・指針>
一連の流れのテストを行わずにリリースするリスクを厚労省も事業者と同程度に認識していれば、事後的にテストを行うことが優先的な課題として位置付けられた可能性もあった。	<政府活動>,<日本>,<その他>
同日開かれた総務省の有識者会議で明らかにした。	<政府活動>,<日本>,<その他>
政府は東京電力福島第1原子力発電所の汚染水を多核種除去設備で浄化したあとに残る処理水の海洋放出を決めた。	<政府活動>,<日本>,<目標・計画・指針>
政府が東京電力福島第1原子力発電所の敷地内でたまる処理水の海洋放出を決めたことを受け、東京電力ホールディングスの小早川智明社長は16日、福島県庁で内堀雅雄知事に会い、放出に関連する規制の順守や風評被害への賠償などの方針を説明した。	<企業活動背景>,<日本>,<その他>
豊田自動織機は15日、ディーゼルエンジンを河川排水ポンプの動力源として使う国土交通省の実証実験に参加すると発表した。	
設立した「レストアファンド」には米金融大手のゴールドマン・サックスや環境保護の非政府組織コンサベーション・インターナショナルも出資する。	
米商務省が15日発表した3月の小売売上高は前月比9.8%増だった。	<政府活動>,<米国>,<その他>
政府は2050年に温暖化ガス排出量を実質ゼロにする目標を掲げている。	<政府活動>,<日本>,<目標・計画・指針>
世界保健機関は3月末、最初に流行した中国湖北省武漢市で1~2月に実施した調査の報告書を公表した。	
