台湾ASUSは1月6日、薄型軽量で有機ELディスプレイを採用するプレミアムなビジネス向けノートPC「Zenbook OLED」シリーズの製品に、第12世代Intel Coreプロセッサや新しいAMD Ryzen 5000シリーズの搭載で刷新した新モデルを発表した。	製品化・サービス化
加古川の仏壇・仏具店が「ファンタジー仏壇」、カスタマイズも 仏壇・仏具店「素心」が1月31日、プラスチック加工会社「匠工芸」とのコラボ仏壇「ファンタジー仏壇Prayer Spot~旅立ち~」の販売を始めた。	製品化・サービス化
ロジテックINAソリューションズが、スティック型ポータブルSSD「LMD-SPBU3」シリーズを発売しました。	製品化・サービス化
株式会社Nabocul Cosmeticsは、2022年1月12日から14日まで東京ビッグサイトで開催された「2022年東京化粧品展覧会COSME TOKYO」に初出展し、新しいエイジングケア分野の最新テクノロジー化合物「OLANDU」を発表しました。	製品化・サービス化
"日本全国に料理と飲み物を1箱にしたフードボックス"をお届けする「nonpi foodboxTM」を展開する株式会社ノンピは、2022年3月4日から「神田明神下みやび、桜満開お花見プラン」を販売開始いたします。	製品化・サービス化
これによりアイティーエムは、オープンソースや内部ホストの脆弱性管理サービスの提供範囲を拡大し、セキュリティ運用をアウトソースする企業もyamoryを利用可能になります。	製品化・サービス化
愛知県東郷町に本社をかまえるホワイトハウスは、ジャパンキャンピングカーショー2022で、N-VANコンポのポップアップルーフつき"Cabin"を展示。	その他
スパトレは2021年4月より東京書籍が発行する中学校英語教科書「NEW HORIZON」に準拠したオンライン英語トレーニングの提供をスタートいたしました。	製品化・サービス化
金沢大発ベンチャー「Kanazawa Diamond」が、独自技術で人工的に製造した黒いダイヤモンドの販売を2022年秋ごろに始める計画だ。	製品化・サービス化
イマジニアは,氷上で行うウィンタースポーツ「カーリング」を手軽に楽しめるNintendo Switch向けソフト「みんなのカーリング」を,本日発売した。	製品化・サービス化
スマホで買える太陽光発電所「CHANGE」を提供する株式会社チェンジ・ザ・ワールドは、「グリーンワット」第2弾の販売を2022年2月9日より開始しましたので、お知らせいたします。	製品化・サービス化
そんななか北欧・フィンランド発の「WOLT」は、食品小売業との提携を加速させるほか、ダークストアを活用した独自の食品配達サービスにも着手するなど、新たな動きを見せている。	製品化・サービス化
松下電器産業株式会社ホームアプライアンスグループは、業界で初めて口全てにIHヒーターを搭載したIHクッキングヒーター4機種に加え、従来、最上位機種に採用し、ご好評をいただいている「音声ガイド」を搭載した3機種を開発しました。	製研究・開発
アスザックフーズ株式会社は「水でできる大根おろし」を2022年3月1日から順次発売します。	製品化・サービス化
ビジネス現場のコミュニケーションツール「LINE WORKS」を提供するワークスモバイルジャパン株式会社は、お使いのLINE WORKS IDのQRコードが印刷されたシール100枚を、先着500名様に無料でお届けする「"あなた専用のQRコード"、シールでお届けキャンペーン」を開始することをお知らせいたします。	製品化・サービス化
メルセデス・ベンツ日本は、メルセデスAMG「GT 4ドアクーペ」の2022年モデルを発表。	製品化・サービス化
創業初期から、NIMASOは、スマートフォンに関連するアクセサリーの開発販売に力を入れ、ブラントを発展させました。	製品化・サービス化
キリンビバレッジ株式会社は、「トロピカーナ」の、季節のおいしさを楽しみながら栄養補給もできる100%果実飲料"の「ヘルシーフルーツ」シリーズの第3弾として、「トロピカーナ ライチ&グレープフルーツテイスト」を、4月5日より全国で季節限定にて新発売します。	製品化・サービス化
パナソニック株式会社は、2016年10月5日より、放送中の番組や録画した番組を、ビエラやディーガからスマートフォンやタブレットに転送し、外出先や家の好きな部屋で視聴できるリモート視聴用アプリ「Panasonic Media Access」をより便利により使いやすく、バージョンアップしました。	製品化・サービス化
AmPmが、ダンストラック「Tokyo」をリミックスした「Tokyo、」の配信を開始した。	製品化・サービス化
グローバル刃物メーカーの貝印株式会社は、「ねこ」をテーマとしたビューティーツールシリーズ「Nyarming」の新商品「ねこのシャンプーグローブ」「ねこの洗顔ブラシ」を、2022年3月8日より、貝印公式オンラインストアをはじめ、全国のドラッグストア、ホームセンター、大手量販店などにて発売いたします。	製品化・サービス化
株式会社日立製作所と株式会社ソラコムは、このたび、両社における協業を加速し、IoTの活用により業務の効率化や価値創出などに取り組むさまざまな企業向けに、IoTサービスを強化します。	製品化・サービス化
パナソニック四国エレクトロニクス株式会社、パナソニック補聴器株式会社は、"聞きたい音をよりくっきり、よりはっきり"と題し、入力音を128バンドの周波数帯域に分割し独立して処理することのできる高性能DSPを搭載したデジタル補聴器「ONWAモデルEJシリーズ」5形状、全8機種を2007年8月20日より発売いたします。	製品化・サービス化
有限会社トラッドは、通常のバックパックに、「浮き」に変身する新しい機能を付け加えたバックパックを発表します。	製品化・サービス化
オンラインショップ「KALE FARM」から、無農薬・無化学肥料で育てたケールのコールドプレスジュースと、イギリス発のオーガニックオーツミルクを組み合わせた新作ケールジュース「ケールオーツミルク」が、1月21日より発売中だ。	製品化・サービス化
NECネッツエスアイと住友理工、バイタルセンサーを活用したホテルサービスの実証実験を開始:時事ドットコム、~睡眠状態の可視化により快適な宿泊環境と良質な眠りを実現~NECネッツエスアイと住友理工は、ルームマネジメントシステムとバイタルセンサー「モニライフ」を組み合わせたホテル向けサービスの実証実験を本日よりホテル コレクティブにて開始します。	製研究・開発
サイバーステップ株式会社は、2,000万ダウンロードを突破したクレーンゲームアプリ「トレバ」にて、2022年1月26日15:00より、「ぶぃっこ」シリーズ第二弾として、「星めぐり学園」所属のVTuber「帝」の限定プライズ、10回連続TPプレイで必ず獲得できる「ぶぃっこ、~帝~ VTuberアクリルスタンドシリーズ、Vol.2」が登場することを発表しました。	
ユニットコムは2月10日、iiyama PC LEVELブランドから、「リネージュW」推奨パソコンの販売を開始した。	製品化・サービス化
タイヤ業界が自動車タイヤのサステナブル化に向けて動き出した。	
NPO法人ラ・レーチェ・リーグ日本は、母乳が楽になる、軌道に乗せやすくなる情報をシンプル&コンパクトに提供する「母乳育児かんたんスタートガイド」を2022年2月16日より発売開始しました。	製品化・サービス化
企業は近年、主にSNSで影響力を持つインフルエンサーに、ブランドやサービスを紹介してもらうマーケティング手法「インフルエンサーマーケティング」を実施している。	製品化・サービス化
新潟市は、自動車道の一部を歩行空間にしてテーブルやベンチを置きにぎわい空間を創出する社会実験を今秋に行う。	製研究・開発
トヨタは東京オートサロン2022で「GRMNヤリス」を発表。	製品化・サービス化
ミニストップは、人気の「やみつキッチン」シリーズから登場する菓子パンの新商品「やみつきになる!、チョコクリームパン」を、2022年1月11日より国内のミニストップ店舗にて発売します。	製品化・サービス化
サードウェーブは、ハイエンドビデオカード「NVIDIA GeForce RTX 3080 12GB」を搭載したゲーミングPC「GALLERIA」2機種の販売を2月10日より開始している。	製品化・サービス化
ミノン初の日焼け止め「ミノンUVマイルドミルク」が、2022年2月25日より発売される。	製品化・サービス化
IHI運搬機械は12月28日、機械式駐車装置において、省電力で、全ての電気自動車への充電を可能とする新システムを開発したと発表した。	製研究・開発
Y&Y STOREは、本日2022年2月24日よりコスパ抜群のレーザー彫刻機「Runmecy D4」を、GREEN FUNDINGにて販売を開始しました。	製品化・サービス化
詳しくはこちら発表日:2022年02月03日ロボットのビル内移動を支援、オフィスの利便性向上とビル管理の省人化・省力化を実現「アーバンネット名古屋ネクスタビル」で「ロボット移動支援サービス」を提供三菱電機株式会社は、1月31日に竣工した「アーバンネット名古屋ネクスタビル」に、サービスロボットと連携するエレベーターと入退室管理システムを納入し、ロボットのビル内自律移動を支援する「ロボット移動支援サービス」を提供します。	製品化・サービス化
イオン・シグナ・スポーツ・ユナイテッド株式会社は、スポーツバイクEC専門ショップ「Probikeshop」において、株式会社自転車創業が展開する日本最大級の自転車メディア「FRAME」とコンテンツ面で連携を強化し、EC領域の協業に加え、動画の共同コンテンツ制作を展開していきます。	製品化・サービス化
合同会社フロッグワークスは、全国の視覚に障害をお持ちの方に向けたサービス「視覚障害者向けパソコン・スマホITサポートと視覚障害者専用パソコン・支援機器の販売」を行う事業「ブラインドITヘルパー」を、令和3年12月1日から開始いたしました。	製品化・サービス化
JR西日本は16日、岡山と山陰地方を結ぶ特急「やくも」用に、新型車両「273系」を新開発すると発表した。	製研究・開発
全国でウェディングプロデュースを手がける婚礼大手の株式会社テイクアンドギヴ・ニーズは、全国の店舗にて、オンラインウェディングサービス「ENISHI」の提供を2022年4月より開始いたします。	製品化・サービス化
株式会社リアライズは、3月2日~3月5日までの期間中、アニメ・漫画専門ECサイトであるAnimoで「名探偵コナン アクリルフィギュア、PALE TONE series flower ver.」の予約販売を開始いたします!	製品化・サービス化
楽しみながらプログラミングを学習できる教材の開発競争が活発になっている。	
田中電子工業では、中国における生産子会社の田中電子有限公司で、2001年より各種ボンディングワイヤの製造と、中国における技術サービス業務の提供を行ってきた。	製品化・サービス化
日産自動車は12日、電気自動車の充放電を自律制御するシステムを活用したエネルギーマネジメントの実証実験を13日から福島県浪江町で開始すると発表した。	製研究・開発
ヤマハ発動機は2022年3月11日、バッテリー着脱式の電動スクーター「NEO'S」を欧州で3月に発売すると発表しました。	製品化・サービス化
一方、パリなど海外ではシェアサイクルなどとともに「電動キックボード」のシェアリングサービスが普及しています。	製品化・サービス化
ボーイングは全面刷新した次世代航空機の立案を開始した。	その他
プラント大手の日揮や全日空、日本航空、日清食品など16社は温室効果ガスの排出量が少ない次世代航空燃料=SAFの国内での商用化と普及を目指す団体を立ち上げました。	製品化・サービス化
みちのりグループは、昨年、日本初のバス車内におけるVisaタッチ決済を導入しました。	製品化・サービス化
米LEMOREは、「MOFT」ブランドの新商品として、「MOFT Snap、ノートパソコン用スマホホルダー」を発売した。	製品化・サービス化
茨城県央地域で地域密着型の介護事業「介護グループ野ばら」を展開する株式会社マネジメントセンターは、水戸地区で唯一となる夜型デイサービス「デイサービス野ばら、しもいち館」を開業しました。	製品化・サービス化
二子玉川、蔦屋家電1階にある次世代型ショールーム「蔦屋家電+」にて、2022年2月25日から世界から注目を集める日本発のAIペット型ロボット「Moflin」の展示がスタートする。	その他
リーガロイヤルホテル広島は、1月4日から4月28日まで、春の訪れを告げるイチゴを使ったテイクアウトスイーツ「イチゴとルバーブのベイクドケーキ」を販売します。	製品化・サービス化
*、西日本鉄道株式会社は、いすゞ自動車株式会社、三菱商事株式会社、福岡国際空港株式会社と共同で、福岡空港内において大型自動運転バスを用いた自動運転の実証実験を2022年3月8日より実施いたします。	製研究・開発
TNL Media株式会社は、新しいニュースメディア「ザ・ニュースレンズ・ジャパン」の配信を本格始動しました。	製品化・サービス化
1985年にパソコン用OSのWindowsを開発。	製研究・開発
子会社が太陽光発電所の建設を開始。	製品化・サービス化
LINEは、LINEトークや通話で専門家やカウンセラーと相談できる同社のサービス「トークCARE」において、新機能「推しキャラトーク」の提供を開始した。	製品化・サービス化
キャンピングカーの製造や販売を行うALFLEXは2月18日、アドセットシリーズの頂点に立つハイエンドモデル「MASTERS LINE」が2月に誕生したと発表。	製品化・サービス化
富士通は2月21日、総務省および経済産業省のガイドラインに基づいてAIシステムの倫理上の影響を評価する方式を開発したことを発表した。	製研究・開発
池田糖化工業では、手軽に菌活できる素材として独自開発した乳酸菌含有素材「ミネラクト乳酸菌」を紹介している。	その他
コーエーテクモゲームスは、三国志の世界を舞台にした歴史アクション&シミュレーションゲーム「真・三國無双8 Empires」を2021年12月23日に発売した。	製品化・サービス化
東洋合成工業が各種半導体材料の増強を進めている。	製品化・サービス化
医療法人社団、やまびこ、本院、新横浜整形外科リウマチ科は、患者の診察およびリハビリテーション後の会計・処方箋発行待ちによる過密対策のため、SMBCグループ、株式会社プラスメディが開発・運営する患者向けスマホアプリ「MyHospital」を令和4年2月15日から導入しサービスを開始いたします。	製品化・サービス化
同社はきょう午前11時30分ごろ、米アンシスが開発・販売・サポートするマルチフィジックス解析ソフトウェア「Ansys」の最新バージョン「Ansys 2022 R1、日本語版」の販売及び技術サポートを開始すると発表した。	製品化・サービス化
勤次郎株式会社と株式会社スマートボックスは、オンライン診療システムと医療通訳サービスを連携し、医療業界への新サービス提供を開始いたします。	製品化・サービス化
佐賀共栄銀行は、店舗窓口でヤマト運輸の宅急便の受け付け業務を始めた。	その他
「ドクターマーチン」が、「ヨウジヤマモト」との新作コラボレーションアイテム「1490 Hidden Zip YY」を発売した。	製品化・サービス化
HyperXから、ワイヤレスゲーミングヘッドセット「HyperX Cloud Core Wireless」が発売された。	製品化・サービス化
アプライアンス・ウェルネス マーケティング本部は、水に包まれた微粒子イオン「ナノイー」を搭載し、加湿と「ナノイー」の相乗効果により、清潔でより高いうるおい効果を実現した加湿セラミックファンヒーター「DS-FKX1201」を9月1日より発売します。	製品化・サービス化
テックウインドは、PGAのトッププロもパター練習ツールとして採用しているパタートレーニングツールブランド「Wellputt」から世界最古のオープンゴルフ競技である「全英オープン」とコラボレーションしたスペシャルエディション「Wellputtマット4m、全英オープンモデル」とパターストロークの軌道を矯正するストロークテンプレート「Wellstroke」の2製品を発売した。	製品化・サービス化
バンダイ カード事業部は、週刊少年ジャンプで連載中の漫画「ONE PIECE」の連載25周年を記念し、本格トレーディングカードゲーム"ONE PIECEカードゲーム"を発売することを発表した。	製品化・サービス化
シャープは、社内のネットワークに侵入したマルウェアなどによる攻撃を遮断し、被害の拡大を抑制するセキュリティスイッチ<BP-X1PL01>を発売します。	製品化・サービス化
銀一は、同社が取り扱うRDE Microphones社のデュアルチャンネル対応ワイヤレスマイクシステムのシングルセット「Wireless GO II Single」と、VideoMic GO II用のウインドシールド「WS12」を2022年2月25日に発売する。	製品化・サービス化
国家資格を持ったキャリアコンサルタントによる無料のオンラインキャリア相談サービス「CHOICE!」を運営する株式会社Compassは、京都市より委託を受けた「就職氷河期世代活躍支援事業」において、日本で初めてAIを用いたアセスメントシステムを開発し、2022年3月1日より運用を開始いたします。	製品化・サービス化
富士フイルムビジネスイノベーションは3月1日、同社のドキュメントハンドリング・ソフトウェア「DocuWorks」を基に開発した新クラウドサービス「DocuWorks Cloud」の提供を発表した。	製品化・サービス化
日本RV協会は2月9日、今後もさらなる拡大が見込まれるキャンピングカー需要に応えるため、最大240回払いが可能な「JRVA特別オートローン」の提供を開始すると発表した。	製品化・サービス化
株式会社Listerは、営業リストを購入できるマーケットプレイス「Listers」にて、営業リストを無料で作成するキャンペーンを実施します。	製品化・サービス化
Googleがペン入力対応のタブレットの開発を水面下で進めているとの噂が、海外を中心に話題になっている。	
三菱電機は、第5世代移動通信システム基地局の間を接続する光ファイバー通信に向けた半導体レーザーを発売した、ニュースリリース、。	
株式会社ヤマダデンキは、TSUKUMOブランドで独自に展開するゲーミングPC「G-GEAR」において、最新の第12世代インテル、CoreプロセッサーとB660チップセット搭載マザーボードを採用したゲーミングPC5機種を1月21日より発売いたします。	製品化・サービス化
環境負荷の少ない効率的な使用済みプラスチックの再資源化技術開発を加速。	製研究・開発
いすゞ自動車株式会社、西日本鉄道株式会社、三菱商事株式会社は、いすゞ製大型バスでの自動運転の共同実証実験を実施することに合意した。	その他
3月1日に、植物性原料だけを使ったフライ製品「Vegesh、カレーフライ」を発売する。	製品化・サービス化
ARK社は容易に導入できる小型/分散型の閉鎖循環式陸上養殖システムを開発するベンチャーです。	
「ジルスチュアート ビューティ」は、2022年1月28日より、紅茶の香りのハンドクリーム5種とボディミルクを限定発売します。	製品化・サービス化
国内製薬会社23社に採用:製薬業界のデジタル化を推進するドキュサインの電子署名:時事ドットコム ドキュサイン・ジャパン株式会社は、国内の製薬企業23社がドキュサインの電子署名ソリューション「DocuSign eSignature」を導入し、業務プロセスのデジタル化を実現していることを発表しました。	製研究・開発
大建工業は、犬の歩行に配慮した"滑りにくさ"というペット視点の機能はもちろん、傷に強い、汚れにくい、変色しにくいといったユーザー視点の機能も併せ持つペット共生住宅用フローリング「ワンラブフロア」を、8月21日から全国発売いたします。	製品化・サービス化
ナショナルウェルネスマーケティング本部は、世界初1光センサー技術による「皮下脂肪スキャナー」2を搭載し、身体の「二の腕・お腹・太もも」それぞれの皮下脂肪の厚みをミリ単位で測定することや、体の重心位置などを測定できる「体組成バランス計」3機種を5月1日より発売します。	製品化・サービス化
アマゾン ウェブ サービスは2月17日、公共分野において課題解決に取り組むスタートアップを支援する新プログラム「AWS Startup Ramp」を日本で開始すると発表した。	製品化・サービス化
滋賀県甲賀市の信楽町民有志でつくる信楽まちなか芸術祭実行委員会は、同町内で信楽中の生徒が開発したマグカップを販売している。	製品化・サービス化
株式会社SUBARUは、富士通株式会社と共同で開発してきた、エンジン部品加工工程における研削加工の品質を高精度に判定するAIモデル、および、製造現場でのAIモデルの管理を支援する富士通の「FUJITSU Manufacturing Industry Solution COLMINA、現場品質AI、運用管理パッケージ」の本格稼働を、2022年1月末よりSUBARUの群馬製作所大泉工場にて開始しました。	製品化・サービス化
株式会社レモネード・レモニカは、オリジナルレシピのレモネード専門店「LEMONADE by Lemonica」を全国に約90店舗展開しています。	
酒菜と串揚げ、釜めしが自慢のレストラン「ごはん酒菜そのに」は、アジフライ専用「味和伊ソース」を開発し、オンラインショップで販売している。	製品化・サービス化
MBSIは、シェアリングやタクシー業、物流サービス等を行うMaaS事業者への二輪車両の貸与を通じて、アセットマネジメント事業を行う。	その他
ガーミンジャパンは1月27日、タッチスクリーン型GPSスマートウォッチ「Venu 2 Plus」の予約販売を始めた。	製品化・サービス化
LDBでは、「与信が難しいことが理由で、受けられる金融サービスが限定的になってしまっている」という中小企業の課題に対して、業界特有のデータやAIを活用した与信システムの開発に取り組み、2020年9月より一部を実用化、第一弾サービスとして建設業向けの金融サービスを提供開始しました。	製品化・サービス化
伊藤忠商事グループの株式会社Belongは、同社が提供する法人向け中古端末のレンタル・販売サービス「Belong One」にて、「Android Enterprise Device Reseller、認定取得」及び「Android Enterprise Essentials」の提供を記念し、法人のお客様により手軽かつセキュアな状態で、Android、端末をご導入頂けるよう、キャンペーンを開始いたします。	製品化・サービス化
「OptiNAND」技術を採用したWestern Digitalのデータセンター向け20TB HDD「Ultrastar DC HC560」が登場、オリオスペックが非SEDモデル「WUH722020ALE6L4」の販売を開始した。	製品化・サービス化
富山市は、市役所市民課などの窓口の混雑状況をスマートフォンやパソコンで確認できるサービスを始めた。	製品化・サービス化
キージェントは、ケーブルテレビやインターネットをエンドユーザーへ提供する通信業界、電気・ガス等のインフラ業界で、人材派遣やアウトソーシングを主体とするサービスを展開しています。	製品化・サービス化
*テクノストラクチャー ホームページパナソニックESテクノストラクチャー株式会社、ホームページパナソニック株式会社、エコソリューションズ社では、阪神・淡路大震災の起こった1995年に、従来の在来木造工法に鉄の強さを取り入れ独自開発した、木造耐震住宅工法「テクノストラクチャー」を発売。	製品化・サービス化
「Play fashion!」をミッションに掲げる株式会社アダストリアが展開するGLOBAL WORKは、仕事やプライベートでアクティブに自転車を活用する人々に向けたインブランド「Blintw」の2022年春夏アイテムを2月19日より順次発売いたします。	製品化・サービス化
Razerより、音と連動する振動機能を搭載したワイヤレスゲーミングヘッドセット「Kraken V3 Pro」が2022年3月18日に発売される。	製品化・サービス化
株式会社レモネード・レモニカは、オリジナルレシピのレモネード専門店「LEMONADE by Lemonica」を全国に約90店舗展開しています。	
株式会社SEMABIZは特許専門調査会社ネオテクノロジー「二酸化炭素CO2分離膜」の販売を2022年3月9日に開始いたしました。	製品化・サービス化
株式会社ネインは、スマートフォンと連携して様々なキャラクターボイスによる音声アシスタントと連携できるスマートイヤフォン「Zeeny Lights 2」と、「Fate/Grand Order -絶対魔獣戦線バビロニア-」の登場キャラクター「ギルガメッシュ」、「Fate/Grand Order -終局特異点、冠位時間神殿ソロモン-」の登場キャラクター「ロマニ・アーキマン」「レフ・ライノール/ゲーティア」とのコラボレーションモデルの予約販売を開始いたします。	製品化・サービス化
コンビニチェーン・ファミリーマートでは8日から、肉のうまみにこだわった、「肉弁当、四天王」が発売される。	製品化・サービス化
日本全国、海外で街のゴミ拾い活動を展開する認定NPO法人グリーンバードは、魔法のソファ「Yogibo」を運営する株式会社ウェブシャークが展開する、社会課題解決支援プロジェクト「TANZAQ」に参画し、アップサイクルプロジェクト「RePLAMO」と新ゴミ拾いグッズをリリース。	製品化・サービス化
エステーは、この環境下での快適な生活をサポートするとともに、環境に配慮した生活ができるよう商品開発を強化。	製研究・開発
デジタルメディアの広告運用チーム向けに異常検知とワークフロー改善技術を提供する「oolo」は、日本での事業を開始し、日本国内のメディア企業に収益モニタリングソリューションの提供を開始します。	製品化・サービス化
デジタルAVCマーケティング本部は、高級タイプの女性向け密閉型インサイドホン「Classy Jewel」RP-HJF7を10月15日より発売します。	製品化・サービス化
クリスピー・クリーム・ドーナツ・ジャパンは、ジェイアール名古屋タカシマヤ店限定「クリスピー・クリーム・プレミアム」の新商品として、「クリスピー・クリーム・プレミアム ローズ&フランボワーズ」を3月1日から期間限定で発売する。	製品化・サービス化
IIJは2月2日、モバイル、クラウド、MDCなど同社の各種サービスを組み合わせたエッジコンピューティング環境を体感できるショーケースの開設を発表した。	製品化・サービス化
釣り用品の「ダイワ」を運営するグローブライドのアパレルブランド「ディーベック」は、中嶋峻太が手掛けるメンズブランド「オールモストブラック」と協業したカプセルコレクションを1月27日に発売する。	製品化・サービス化
青森県八戸市の東北医療福祉事業協同組合と弘前大学地域戦略研究所が、2020年に閉館した旧「はちのへゆーゆらんど新八温泉」でトラフグの陸上養殖試験を行っていることが7日分かった。	
青森県今別町の有志が町の伝統芸能・荒馬のロゴをデザインした立体型の布マスクを製作した。	製品化・サービス化
県立球磨中央高校の生徒と山崎製パンが球磨地域特産の栗を使った「ランチパック」を共同開発しました。	製研究・開発
東京理科大学の研究グループは、食用トウモロコシを用いて、簡単な手法により、均一サイズのナノ粒子を大量に作製することに成功した。	製研究・開発
NECは、SaaSの設定不備によるセキュリティリスクの可視化や対策を支援する「SaaSセキュリティ設定管理プロフェッショナルサービス」を提供開始した。	製品化・サービス化
晶合光電は2011年に設立され、完成車工場と共同で発光ダイオードモジュールの研究開発や設計を行い、デジタル化、インテリジェント化された車載用ライトを生産する。	製品化・サービス化
ソニー株式会社とパナソニック株式会社は、2012年6月25日付で、テレビ/大型ディスプレイ向けの次世代有機ELパネルおよびモジュールを共同で開発する契約を締結しました。	その他
株式会社GOESWELLは、サブスクリプションサービス「GOESWELL PLUS+」を2022年1月5日より提供開始いたします。	製品化・サービス化
自宅でビールを原料から醸造できる新たな家電が登場した。	
東京建物株式会社のグループ会社で、マンション管理運営部門を担う株式会社東京建物アメニティサポートは、マンション大規模修繕工事の周期を12、年から最大18、年に延長できるサービス「Ever Graceful、」、の提供を開始しますのでお知らせいたします。	製品化・サービス化
内田くんは「光の波紋」をテーマにプログラミングで光の色や強弱を変化させ、水の波紋が広がるような「落ち着くLED照明」を制作。	製品化・サービス化
株式会社ジャパンナノコートが開発した可視光熱触媒コート剤:時事ドットコム、密着性能の高い無機バインダー及びシングルナノ粒子の精製技術により、和紙や金属などあらゆる素材へ固着するコーティング剤は、医療現場や伝統工芸など様々な分野で実用化。	製品化・サービス化
KDDIは、オンライン専用料金プラン「povo2.0」で、謎解きで"ギガ"がもらえるキャンペーン「povo謎~Happy Valentines!! povoとチョコっと*謎解き~」を開始した。	製品化・サービス化
「ミニストップ」は、1月7日から、飲むデザート「グルクル」の新フレーバー「飲むチーズケーキ」を販売する。	製品化・サービス化
全国の木材・木製品製造流通会社、約1万6000社が加盟する一般社団法人全国木材組合連合会は3月14日、地域材を利用した住宅や木製家具などの優良事例を支援する「顔の見える木材での快適空間づくり事業」の報告サイトを同日公開した。	製品化・サービス化
ベアラボは、企業向け研修や組織開発、チームビルディング等をはじめとしたゲーミフィケーション研修を提供。	製品化・サービス化
ベーカリーカフェ「パンとエスプレッソと」をはじめ、国内で22店舗を展開する日と々とが、パニーニ専門店「パニーニ一番」を千駄ヶ谷に出店する。	製品化・サービス化
日本郵政は今後、メールの添付ファイルをクラウドに保存し、Boxのセキュリティ機能でスキャンしてから閲覧する仕組みなどを検討する。	その他
パナソニック サイクルテック株式会社は、集合住宅における居住者向けIoT電動アシスト自転車シェアリングサービスの実証実験を実施する。	製研究・開発
米アップルは次世代通信規格「5G」に対応した廉価版のiPhoneと改良版iPadを、3月8日をめどに発表する計画。	製品化・サービス化
パシフィックネットは、IT機器の導入・運用管理・クラウド・セキュリティを「サブスクリプション」モデルで提供し、適正処分に至るまでの包括的な企業の情報システムを支援するITサービスのオンリーワン企業である。	
詳しくはこちら東京海上日動火災保険は企業向けに、地震発生時に安全確保にかかった実費を補償する保険を販売する。	製品化・サービス化
「Play fashion!」をミッションに掲げる株式会社アダストリアで展開するLEPSIMは、人気モデル・五明祐子さんとコラボレーションした、特別な日をさらに輝かせる華やぎのあるブラウス2型を2月4日より全国のLEPSIM店舗と公式WEBストア、.stにて発売いたします。	製品化・サービス化
東北大学と東芝はこのほど、ネオジムボンド磁石と同等の磁力を有するサマリウム鉄系ボンド磁石を、希土類であるサマリウムの含有量を約半分に削減して開発したと発表した。	
株式会社湖池屋は、ホクレン農業協同組合連合会の協力により原料に北海道産米を使用した、濃厚ノンフライ・たんぱく質入りの新しい米スナック「愛をコメて、ガリシュリ」、「愛をコメて、ミートドリア」を2022年1月24日より全国コンビニエンスストア、湖池屋オンラインショップにて発売します。	製品化・サービス化
宮城県大崎市にある千田清掃では、廃食用油から燃料をつくり、自社車両や自家発電に活用し、さらに販売も行う。	その他
横河レンタ・リースは、医療用画像処理ソフトウエアのHoloeyesと連携してマイクロソフトのウエアラブルコンピューター「ホロレンズ2」のレンタルサービスを拡充する。	製品化・サービス化
エムエスアイコンピュータージャパンは2月11日、オフィスソフトが付属したWindows 11搭載ノートPCのエディオン限定モデル「Sword-15-A11UC-1209JP」と「Modern-15-A11MU-877JP」を発売する。	製品化・サービス化
Razerは、Xboxコントローラー用充電ドック「Universal Quick Charging Stand for Xbox」に、限定デザイン仕様として「Xbox 20th Anniversary Edition」「Forza Horizon 5 Limited Edition」の2製品を発表した。	製品化・サービス化
スポーツ・アウトドア用品を販売する株式会社アルペンは、アルペンアウトドアーズ店舗限定のご当地シェラカップを2022年3月11日より、全国のアルペンアウトドアーズで販売します。	製品化・サービス化
中小企業向けグローバル展開支援SaaS事業を行うToPoLo株式会社は、中小企業を対象とした「共感で世界のパートナーがつながるグローバルビジネスマッチングサービス「ToPoLo」」の提供を2月21日に開始しました。	製品化・サービス化
日本パレットプールは2020年秋から、レンタルパレットの位置確認と管理ができるシステム「フクLOW」を順次導入している。	製品化・サービス化
スプリングバレーブルワリーは1月28日、日本産ホップのおいしさを楽しめる限定ビール「JAPAN HOP~ペールエールタイプ~」をスプリングバレーブルワリー京都で数量限定で提供を開始する。	製品化・サービス化
電子書籍取次のメディアドゥは、ファン向けのNFTを発売するプラットフォーム「FanTop」を2021年10月に開始。	製品化・サービス化
楽天モバイルは、国内で販売されている5G対応スマートフォンで最もスリムなオリジナルスマートフォン「Rakuten Hand 5G」を、2月14日から「楽天モバイル」公式サイト、「楽天モバイル公式、楽天市場店」、「楽天モバイルショップ」で発売する。	製品化・サービス化
完全ワイヤレスイヤホン用のケースやミニポーチのほか、<エルメス>ではiPhoneやiPadの「探す」アプリと連動した「AirTag Hermes」が登場するなど、飾る以外にも機能をもつアクセサリーが発売されている。	製品化・サービス化
PVSQ-Mは、太陽光発電所の技術評価・リスク評価や太陽光パネルの性能・信頼性評価などの専門性の高い評価、調査、技術コンサルティング業務を行っている。	製研究・開発
詳しくはこちらNTTドコモは工事不要で利用できる固定電話サービスを3月下旬から提供するNTTドコモは4日、工事不要で利用できる固定電話サービスを3月下旬から始めると発表した。	製品化・サービス化
株式会社エクサは、社員の自律的な行動と成長の支援を強化するため、組織と個人のより良き関係性構築と個人の主体的なキャリア開発を支援する一般社団法人プロティアン・キャリア協会、のプログラム、「プロティアン・キャリアドック」を2022年1月より導入開始しました。	製品化・サービス化
株式会社TOMORROWは、2022年2月1日より、月々330円で利用できるサブスク型電動歯ブラシサービスを開始いたします。	製品化・サービス化
深層学習を中心とした最先端技術の研究開発を行うPreferred Networksと花王は2月28日、「仮想人体生成モデル」のプロトタイプを共同開発したと発表した。	製研究・開発
NBCユニバーサル・スタジオ・グループの一つであるNBCUniversal Formatsは、カイロを拠点とするメディア制作会社TVisionとOSN、そしてUMSとタッグを組んでアラブ版の「SUITS」製作を進めている。	製品化・サービス化
とんかつ専門店「松のや」「松乃屋」は、「ポルチーニ香るフォアグラ入りクリームコロッケ」を2月16日15時に発売する。	製品化・サービス化
株式会社、学研ホールディングスのグループ会社、株式会社、学研プラスは、iOSアプリ「英語の図鑑で楽しく学ぼう!、こどもえいごずかん」を2022年1月5日に配信開始いたしました。	製品化・サービス化
鹿児島県庁では、庁内情報基盤である行政情報ネットワークの再構築と併せて、職員の在宅勤務実施に向けたコミュニケーションツールの導入を検討していました。	製品化・サービス化
日本郵便信越支社は、諏訪大社式年造営御柱大祭の開催を記念するオリジナルフレーム切手シート2種類を15日から県内全郵便局と一部の簡易郵便局で販売する。	製品化・サービス化
株式会社エビリーは、日本航空株式会社が運営する「JALふるさとプロジェクト」のYouTubeチャンネルの運用支援を開始しました。	製品化・サービス化
プジョーは、最高出力680psのハイブリッド・パワートレインを搭載した新型ハイパーカー「9X8」で、6月のル・マン24時間レースに復帰する予定だ。	
KDDIと沖縄セルラーは、UQ mobileからシャープ製のAndroidスマートフォン「AQUOS sense6」を本日2月18日に発売する。	製品化・サービス化
パナソニックグループのパナソニック ソリューションテクノロジー株式会社は、2011年12月7日東京、および12月9日大阪にて、IT-BCPをテーマにしたセミナーを開催します。	その他
ネットギアジャパン合同会社は25日、法人向けメッシュWi-Fi製品のエントリーモデル「Orbi Pro WiFi 6 Mini」において、ルータ単体モデルを販売開始すると発表した。	製品化・サービス化
中国電力大手の華能国際電力は12月30日、中国山東省徳州市で世界最大の浮体式水上太陽光発電所が完成したと発表した。	製品化・サービス化
カバー株式会社は、弊社が運営するVTuberグループ「ホロライブ」において、株式会社イオンファンタジーが運営するオンラインクレーンゲーム「MOLLY.ONLINE」とのコラボ企画第9弾として、女性VTuberグループ「ホロライブ」のタレント「兎田ぺこら」、「獅白ぼたん」を起用したモーリーオンライン限定プライズゲーム用景品を、1月14日18時より展開します。	製品化・サービス化
ヨドバシカメラは、通販サイト「ヨドバシ・ドット・コム」にて、セール「お得な新春割引キャンペーン」を1月16日まで開催している。	その他
詳しくはこちら発表日:2022年02月16日菱洋エレクトロ、光触媒技術を有するカルテックと代理店契約締結~独自の光触媒材料を用いた除菌・脱臭製品の販売を開始~エレクトロニクス商社の菱洋エレクトロ株式会社は、独自の光触媒技術を応用した除菌脱臭機の開発・販売を手掛けるカルテック株式会社と代理店契約を締結し、光触媒によりウイルスや浮遊菌を分解する除菌・脱臭製品の販売を開始しました。	製品化・サービス化
SaaSソリューション「Ecomedia」を開発するScalably株式会社は、世界的コミュニティが生まれつづける社会をめざした制度「コミュニティ奨学金制度」を開始しました。	製品化・サービス化
からあげ定食専門店「からやま」は、「生姜焼きとり」「生姜からあげ」を、2022年1月14日より、国内の店舗で販売する。	製品化・サービス化
詳しくはこちら発表日:2022年02月15日日本化薬、今後のドローン社会実装に不可欠な安全部品である産業用ドローン向け緊急パラシュートシステム「PARASAFE」を販売開始日本化薬株式会社は、産業用ドローン向け緊急パラシュートシステム「PARASAFE」の販売を開始したことを発表いたします。	製品化・サービス化
ナイキの厚底シューズに対抗すべく、アシックスは同社史上"最速"を謳った「メタスピード」を開発。	製研究・開発
そんな中、ヤマハ発動機では、原付一種サイズの新型EVスクーター「NEO'S」を欧州で3月に発売することを発表しました。	製品化・サービス化
ゼンハイザージャパン株式会社はクリエーターやビデオグラファー、モバイルジャーナリストが動画の音質を向上させるオンカメラマイク、MKE 400-IIと、スマートホンクランプおよびミニ三脚を付属したMKE 400-II Mobile Kit、を1月27日より発売いたします。	製品化・サービス化
株式会社Lentranceは、同社の学習用ICTプラットフォーム「Lentrance」と連動して動作する学習履歴データ分析基盤、「Lentrance Analytics」の商用提供開始を発表いたします。	製品化・サービス化
グローバル刃物メーカーの貝印は、デリケートゾーンの毛量を適度に調整できる「FEMINICARE、すきカミソリ、2本入」を、2022年3月8日より貝印公式オンラインストアをはじめ、全国のドラッグストア、ホームセンター、大手量販店などにて発売しました。	製品化・サービス化
モランボン株式会社は、精肉売場向け商品として、「韓の食菜、ヤンニョムだれ・にんにくごま油だれ」を2月15日より新発売いたします。	製品化・サービス化
当社は、企業の与信審査から請求書発行、代金回収までの決済業務を一括して代行する企業間後払い決済サービス「マネーフォワード ケッサイ」を提供しています。	製品化・サービス化
MINISFORUMは、AMD B550チップセットを搭載し、外付けでビデオカードを追加できるミニデスクトップを発表した。	製品化・サービス化
松屋フーズは、同社が展開する牛めし・カレー・定食の「松屋」において、「キムチ牛鍋」を1月11日15時に、「焼キムチ牛めし」を1月18日10時に発売する。	製品化・サービス化
途上国の水・衛生支援に取り組む国際NGOである特定非営利活動法人ウォーターエイドジャパンは、3月22日の世界水の日に向けて、世界を青く染めるキャンペーン「#Blue4Water」を実施します。	製品化・サービス化
パナソニック株式会社、エコソリューションズ社は、2012年10月21日発売のホームエネルギーマネジメントシステム「スマートHEMS」を2013年7月末に、3万台販売達成しました。	製品化・サービス化
株式会社グランディール ジャパンは、今だけでなく将来のためにも肌のベースづくりと栄養補給が大切であることに着目し、ヒト臍帯血細胞順化培養液をはじめとする4つの"覚醒"成分1 2とプラセンタエキスなどの有用成分1を黄金比で配合した"攻めの美容液"「FABULOUS ONE、スキンセラムRE」を開発し、2022年1月26日に公式サイトにて販売を開始いたします。	製品化・サービス化
ダンサーでもあるデザイナーのサウル・ナッシュは、メリノウールのスエットやパーカーなど、着心地と高級感を備えたストリートウエアを披露した。	製品化・サービス化
GHG排出量算定・可視化クラウドサービス「zeroboard」を開発・提供する株式会社ゼロボードは、大崎電気工業株式会社、エネルギーアンドシステムプランニング株式会社とともに、企業の脱炭素化に向けた支援に関する協業を開始いたします。	製品化・サービス化
そんなサステナブルブランドの先駆者であるパタゴニアから、PC周辺機器を簡単に取り出せるパッド入りスリーブを備えたデイパック「レフュジオ・デイパック」が登場。	製品化・サービス化
車やバイクのLED・HID専門店「fcl.」のブランドでカーパーツの販売を行う「WiNEEDS HOLDINGS」は2月8日、新型トヨタ車専用の純正LEDフォグランプを純正の5倍の明るさに交換出来る「LEDフォグランプ」を発表、同日より予約販売を開始した。	製品化・サービス化
同社は5日取引終了後、自社の全自動免疫測定装置「HISCL-5000/HISCL-800」を用いて血液中の脳内アミロイドを測定する検査試薬について、医薬品医療機器総合機構へ製造販売承認を申請したと発表したが、反応は限定的。	
花王のグローバルカウンセリングブランド「センサイ」が、エイジングケアクリーム「センサイ、AS、イルミナティブクリーム」を3月2日に発売する。	製品化・サービス化
新社会システム総合研究所は、1996年12月6日に設立、創業以来26年以上、法人向けビジネスセミナーを年間約500回企画開催する情報提供サービスを主な事業としております。	
こういった手法を踏まえて、長谷工コーポレーションは、これまで培ってきたマンションの設計・施工技術に、ロンビックジャパンが保有する耐震スリット施工のテクノロジーを融合し、後施工部分スリットによる柱の耐震補強工法を2011年に開発した。	製研究・開発
半導体の基盤となるウエハーを研磨する「CMP装置」の生産能力を急拡大させ、世界的な半導体需要の高まりに対応する。	その他
株式会社伊と幸は、2022年2月8日から2月9日に開催の「KIMONOの森、音楽ライブ&展示会」において、サステナブル素材としての「絹」の魅力と価値を、楽しく、簡単に学ぶことができるメタバース「繭の小道」を発表、展示いたします。	その他
NTTドコモは、同社のイベント「docomo Open House'22」において、「3Dアバターを用いた表情伝送」に関する技術を展示した。	その他
TOMPLA株式会社と新潟市は連携し、鳥屋野潟周辺においてドローンを使用したコーヒー配送サービスを2022年1月8日に限定で実施しました。	製品化・サービス化
創業4年の同社はこれまで、中国のゴビパートナーズ、セコイア・キャピタル・チャイナ、ZhenFundなどの支援を受け、Eバイクや電動自転車のシェアリングサービスを行ってきた。	製品化・サービス化
電池サプライチェーン協議会は、業界統一的な計算方法を確立し、車載用リチウムイオン2次電池のカーボンフットプリント算定に取り組む。	製品化・サービス化
ドキュサイン・ジャパン株式会社は、国内の製薬企業23社がドキュサインの電子署名ソリューション「DocuSign eSignature」を導入し、業務プロセスのデジタル化を実現していることを発表しました。	製研究・開発
「若々しく健康的な生活を提供する」をパーパスにサプリメントや化粧品の販売を行う株式会社わかさ生活は、力強い歩みをサポートするブラックジンジャー抽出物やグルコサミンなどの有用成分12種類を配合したサプリメント「ムーブメンテ」を2022年3月16日より販売いたします。	製品化・サービス化
川崎市の食品ベンチャー「日本食生活総研」は、職場への冷凍食品の配達サービスを始めた。	製品化・サービス化
ヤマダホールディングスは2月から、オーエムネットワークが提供する小売業・サービス業向けシフト管理ソフト「アールシフト」を本格導入し、ヤマダデンキ・グループ会社の全1065店舗で順次稼働していく。	その他
株式会社Asobicaは、Classi株式会社へ、当社カスタマーサクセスプラットホーム「coorum」の提供を開始したことをお知らせいたします。	製品化・サービス化
パナソニック株式会社、エコソリューションズ社は、軽量で、耐震性にすぐれた「機能屋根システム」を開発しました。	製研究・開発
また、MIRAI-LABOは太陽光路面発電パネルの開発などを行なっている。	製研究・開発
詳しくはこちら大豆肉を使ったカレーとシチューを発売する伊藤ハムは大豆肉を使った「まるでお肉!」シリーズから、カレーとシチューを10日に発売する。	製品化・サービス化
東武鉄道は、5月9日から'23年3月31日までの平日に、東武線のPASMO通勤定期券でピーク時間帯を避けて乗車するとマイルがたまる「オフピークマイル」サービスの社会実験を実施する。	製研究・開発
詳しくはこちらセイコーエプソンが3Dプリンターに参入する。	製品化・サービス化
渡島総合振興局は、道南地域で食産業に携わる事業者を対象に、オンライン商談やSNSを活用した情報発信などの「デジタル力」向上を図る無料セミナーを1月~3月に開催する。	その他
株式会社プラザクリエイトは、シリーズ累計出荷数130万個突破の大人気、DIY、クラフトキット「つくるんです」より、古きよき中国の書斎を再現したチャイナミニチュアハウス「モーシャンカク」を新発売いたします。	製品化・サービス化
ミツビシは市販化予定の軽EV「K-EV concept X Style」を初公開。	製研究・開発
2022年2月8日、アルファロメオは、同ブランド初となるプラグインハイブリッドを含む新型SUVの「トナーレ」を発表しました。	製品化・サービス化
株式会社リットシティは、自社開発の自治体向け広報・防災アプリ「Ap-Portal」に、国民保護情報や警報など、緊急時のお知らせの際に鳴動する通知音を追加し、通常の通知と識別できる新機能を追加開発したことをお知らせ致します。	製品化・サービス化
株式会社バンクリは、印象派モネをイメージしたウォールアートと約2,000本のリアルフラワーを組み合わせた新感覚のアートダイニング&バー「MONE」を3月4日に、東京・新宿三丁目にオープンいたします。	製品化・サービス化
東北エリアを中心に歴史ある寺社仏閣での結婚式を展開する空地音ハーモニーが、1月17日より、CM「みちのく和婚A篇」の放映を開始した。	その他
三井不動産株式会社は10日、事業継続計画の策定から運用・改善までを支援する定額・会員制コンサルティングサービス「&Resilience」の提供を開始した。	製品化・サービス化
アスクは、LGエレクトロニクスの透過型OLEDサイネージモニター「55EW5G-A」の取り扱いを開始した。	製品化・サービス化
フォントワークス株式会社は1月24日、新しいWebコンテンツ「MOJICITY」をスタートしたと発表した。	製品化・サービス化
ドウシシャは、煙と油ハネを大幅にカットできるという「減煙プレート付きコンパクトホットプレート、HPW-101」を、1月下旬に発売する。	製品化・サービス化
NECは、75歳以上の高齢者が運転免許更新時に受ける認知機能検査を、スマートフォンやパソコンから24時間予約できるシステムを構築し、警視庁に導入した。	製品化・サービス化
株式会社ナゴウェブは、2022年3月1日にポイント自動比較サービス「ポイントサイト比較ガイド」を「ポイント比較ガイド」というサービス名に変更しました。	製品化・サービス化
株式会社Mr. CHEESECAKEは、2022年1月30日より、華やかな箔を使用したオリジナルデザインのギフトラッピングとギフトバッグの販売を開始します。	製品化・サービス化
コンピュータートレーニング教材制作、eラーニング向けコンテンツ制作のアテイン株式会社は、月額2,800円で様々な動画講座が視聴し放題のクラウドeラーニングサービス「動学.tv」に、事務に必須のツール「Microsoft Word 2019」の使い方が字幕付きの動画で学べる「Microsoft Word 2019、使い方」講座を2巻構成で、1月24日に公開します。	製品化・サービス化
Coinbase国内におけるカスタマーサポート強化に向け、電話サポートサービスを開始:時事ドットコム カスタマーサポートサービスを強化し更なる顧客対応の向上を目指します世界最大級の暗号資産取引所「Coinbase」を運営するCoinbase株式会社は、顧客の利便性を高める為に、国内での電話サポートサービスを開始致しました。	製品化・サービス化
グループ傘下の対話アプリViberでは、ウクライナで音声通話機能を無料で利用できるクーポンも配布している。	製品化・サービス化
UCC上島珈琲は3月2日、外食業態「上島珈琲店」ブランドの家庭向け商品のプロモーションの一環で、ポップアップストア「STORY OF THE REAL COFFEE OMOTESANDO」をオープンした。	製品化・サービス化
ワフーが待望のパワーメーター搭載スピードプレイペダル"POWRLINK ZERO"を発表した。	製品化・サービス化
全但バスと自動車用電子機器メーカーのデンソーテンなどは、観光客らの予約を受けて自動で経路を選び、運行するオンデマンド予約バスの実証実験を始めた。	製研究・開発
インテルが「仮想通貨のマイニング専用プロセッサ」を開発する理由。	
FTTOソリューション:ファーウェイは、IPと光製品の技術的優位性を統合して、環境に優しく、簡素化されたキャンパスネットワークの構築に向けてFiber To The Officeソリューションの提供を開始した。	製品化・サービス化
ファインピース株式会社は自動車整備業界に特化し技術研修や企業の人材育成をサポートする外国人人材プラットフォーム「外国人整備士.com」と共に、コロナ禍のこの1年で新規採用が「約4.3倍」伸びている「特定技能外国人」についての無料相談サービスを開始することを決定した。	製品化・サービス化
UberEATS部門でオンデマンド医療サービスに進出。	製品化・サービス化
2Kは、プレイステーション、5/プレイステーション、4/Xbox Series X|S/Xbox One/PC用プロレスゲーム「WWE 2K22」を本日発売する。	製品化・サービス化
ブックシェルフスピーカー「SB-C600」、パナソニックは、Technicsブランドの新製品として新開発の同軸ユニットを採用した小型ブックシェルフスピーカー「SB-C600」を2月25日に発売する。	製品化・サービス化
店舗運営者・マーケティング担当の方向け~今後のリアル店舗の在り方~:時事ドットコム、~ポップアップイベントの最新動向と空きスペースの活用方法~、印刷・集客のシェアリングプラットフォームを展開するラクスル株式会社は多拠点大企業向けに販促管理ツールを提供しています。	製品化・サービス化
GMOインターネットグループのGMOフィナンシャルホールディングス株式会社の連結会社で、暗号資産取引業を営むGMOコイン株式会社は、GMOフィナンシャルホールディングスで培われた金融サービス提供のノウハウを活かし、安心して暗号資産のお取引ができる環境を提供しています。	製品化・サービス化
パナソニック株式会社は、パナソニックコンシューマーマーケティング株式会社がWEB上に運営するPanasonic PCの直販サイト「マイレッツ倶楽部」にて、モバイルノートパソコン レッツノート秋冬モデル新製品を9月22日より順次発売します。	製品化・サービス化
エスビー食品株式会社は、簡便ニーズの高まりを受け拡大傾向にあるパック商材のメニューの拡充として、「おうちでアジアめし、ガパオ、3、個パック」「おうちでアジアめし、魯肉飯、3、個パック」を新発売します。	製品化・サービス化
ベクトルは6日、就活生に向けて自己PR動画のアドバイスサービスを開始した。	製品化・サービス化
東武トップツアーズ株式会社と栃木県小山市は、小山市コミュニティバス「おーバス」において、モバイル回数券のサービスを2月1日より開始する。	製品化・サービス化
エレコム株式会社は、AC差込口対応機器やUSB電源機器をまとめて接続できるUSBポート搭載のタワー型タップ「ECT-2120」「ECT-2220」を2月8日に発売した。	製品化・サービス化
メルセデスAMGは、スピリチュアルなミームからヒントを得たと思われる最新のパフォーマンスカーを公開した。	製品化・サービス化
サービス・商品ラピュタロボティクスは21日、「第6回ロボデックスロボット開発・活用展」で、ピッキングアシストAMRの導入イメージを体感してもらうブースを展開。	製品化・サービス化
ニッセンは、オンライン決済サービス「楽天ペイ」の導入を記念して、楽天ポイントを最大3%還元するキャンペーンを開始した。	製品化・サービス化
カゴメとプラントベースフードなどを展開するスタートアップ企業・TWOは、かねて共同で進めていたPFB商品の開発に成功した。	製研究・開発
POSソリューションの台湾企業ポジフレックスは、米インテルのエルクハート・レイク・プロセッサーを基盤とする新しい製品シリーズを今年第2四半期に発売すると発表した。	製品化・サービス化
エムエスアイコンピュータージャパン株式会社は、WQHD/240Hz液晶やGeForce RTX 3080を搭載する17.3型ゲーミングノート「GS76-11UH-650JP」など、ノートPC製品の直販限定モデルを複数発表した。	製品化・サービス化
EarFun Technologyは、片耳3.9gの軽量設計を施した完全ワイヤレスイヤフォン「EarFun Free Mini」を発売。	製品化・サービス化
AiDDEは新型折畳式電動原動機付自転車「D1」をAmazon、楽天、ヤフーショッピングの自社ストアにて販売を開始いたしました。	製品化・サービス化
「センスインタナショナル」が展開する独自ブランド「SCAMPER」より、バレンタイン・ホワイトデーの贈り物や、卒業・入学シーズンにぴったりな、ソープフラワーギフトの販売がスタートした。	製品化・サービス化
OKRや1on1、リアルタイムフィードバック、人事評価等などパフォーマンス・マネジメントを実現するオールインワンクラウド「HiManager」を提供する、ハイマネージャー株式会社は、経営者・人事担当者様の1on1への理解と導入支援を目的にした、「1on1パーフェクトガイド」を無料公開しました。	製品化・サービス化
株式会社ドトールコーヒーは、プラスチックごみの削減を目的に、エクセルシオール カフェのテイクアウト用アイスドリンクカップを、2022年2月中旬より順次プラスチック製からFSC認証紙製に切り替えていきます。	製品化・サービス化
セブン-イレブンは「7プレミアム ブルーベリーチョコレートバー」を、2022年2月22日以降順次発売しました。	製品化・サービス化
都は、新型コロナウイルスのワクチン接種を進めるため「TOKYOワクションアプリ」を展開しています。	製品化・サービス化
伊那市は新年度、市立の19保育園と園児の保護者をオンラインで結ぶ、「保育園ICT化ネットワーク構築事業」に着手する。	製品化・サービス化
1978年に英国で誕生し、英国、アメリカ、カナダ、オーストラリア、フランスなどへの海外留学の支援を行なっている留学エージェント、株式会社アフィニティでは、この度ドイツ人の専任進学アドバイザーがドイツの大学・大学院への進学サポートを日本語で行うという業界初のサービスを本格始動しました。	製品化・サービス化
KDDIは、高速バスのチケット購入額の30%を還元する「au Moves、春のバス推し祭」を開始した。	製品化・サービス化
イトーキはオフィス家具の大手で、物流機器などの設備機器関連も展開している。	
サンディエゴ発-2022年3月1日-、エンタープライズ・アナリティクス向けのコネクテッド・マルチクラウド・データプラットフォーム「Teradata Vantage」を提供するテラデータは、「Everyday AI」のためのプラットフォーム「Dataiku」向けに、新たな分析統合コンポーネント「Teradata Plugins for Dataiku」の提供を開始したと発表しました。	製品化・サービス化
ダイヤは、持ち手付きでフックに引っかけられる「レジ袋みたいな洗濯ネット」を1月25日に発売する。	製品化・サービス化
株式会社アーク パソコンショップアークは、ゲーミングPC「arkhive Gaming Alliance」シリーズに、GeForce RTX 3080 Tiを搭載したPowered By MSIモデルを追加した。	製品化・サービス化
Raspberry Pi財団は、「Raspberry Pi Pico」を動かす「RP2040」チップのまとめ買い割引価格での販売を開始した。	製品化・サービス化
アサヒ飲料は「Welch's 1房分のぶどう」を15日から全国発売する。	製品化・サービス化
大日本印刷が、企業のデジタルトランスフォーメーションの取り組みを支援するサービスを開始した。	製品化・サービス化
Q-pot.は、ディズニー"ミニーマウス"&"デイジーダック"のスペシャルアートを使用した<Vintage Cake Collection>第2弾の小物・アクセサリーを、2022年2月11日よりQ-pot.直営店などにて発売する。	製品化・サービス化
株式会社バンダイ アジアトイ戦略部は、「テレビアニメ「鬼滅の刃」遊郭編」に登場する武器「日輪刀」を再現した音声搭載なりきり玩具「鬼滅の刃、NARIKIRI日輪刀」シリーズの第4弾「鬼滅の刃、NARIKIRI日輪刀~宇髄天元~」を2022年4月23日に発売予定、2022年1月31日より予約を開始します。	製品化・サービス化
オムロン株式会社は、2022年3月9日から12日まで東京ビッグサイトで開催される世界最大級のロボット・トレードショー「2022国際ロボット展」に最新式の卓球ロボット「FORPHEUS」を出展する。	製品化・サービス化
カーメイトはルーフキャリアブランド「イノー」から、ハイエースの背面に装着可能な業務用リアキャリアを発売した。	製品化・サービス化
理化学研究所は、車で運べる小型の高性能な核磁気共鳴装置を開発した。	製研究・開発
高校、大学や企業などにお金やビジネスに関する研修を提供している合同会社「FPal」では、「お金」についての知識をつけることで、前向きに生きていく学生や社会人になってもらおうと、ファイナンシャル・プランナー資格を持つ社員が独自に開発したゲーム形式のプログラム「Gトレ」を展開しています。	製品化・サービス化
動画を起点として1,700社以上の企業にコンサルティング事業を展開する株式会社LOCUSは、高額で効果の見えにくかったTVCMを、手軽に実施且つ効果測定を可能にするサービス「FAST CM」をリリースしましたのでお知らせいたします。	製品化・サービス化
同会は平成24年4月から大和橘の栽培に着手し、菓子やお茶などの開発・販売を進めている。	製品化・サービス化
AVCマーケティング ジャパン本部はiPhoneなどの音楽をワイヤレスで高音質に再生できるAirPlay対応のコンパクトステレオシステム「SC-AP01」を4月20日より発売します。	製品化・サービス化
飛彈産業株式会社はデザイナー・原研哉氏とのコラボレーションモデルを開発した。	製研究・開発
西日本電信電話と京都大学は2月17日、京都大学プラットフォーム学卓越大学院プログラムにおいて連携し、社会に存在するさまざまなデータを活用して連携する次世代のプラットフォームに関する実証実験を行うための検証環境「Platform Initiative Lab」を共同で整備することを発表した。	製品化・サービス化
FRONTIERブランドでPC等を販売するインバースネットは1月19日、Alder Lakeこと第12世代Intel Coreプロセッサを搭載するコンパクトなデスクトップPCを、「GKシリーズ」「GXシリーズ」からあわせて6機種発売した。	製品化・サービス化
阪和興業は7日、脱炭素社会の実現に向け、簡易車庫の屋上に太陽光発電設備を備えた鋼製の「ソーラーカーポート設置事業」を新たに開始したと発表した。	製品化・サービス化
日鉄ソリューションズ株式会社は、小売電気事業者向けに電力取引・リスク管理サービスを2022年5月にリリースし、サブスクリプションモデルでご提供します。	製品化・サービス化
日立ソリューションズは、社会生活や企業活動を支えるソリューションを提供し、持続可能な社会の実現に取り組んでいます。	製品化・サービス化
株式会社WIPは、CBDを配合したフレグランスやオーガニックオイルなどライフスタイルに特化した日本発のウェルネスCBDブランド「METASU|ミタス」にて、CBD配合の発砲タブレットタイプの入浴剤「CBD BATH TABLET」の販売を公式オンラインショップにて開始。	製品化・サービス化
ドミノ・ピザ ジャパンは「成人の日」である1月10日、この日限定で「ピザでつながる」をテーマに新成人へピザを無料プレゼントするキャンペーンを全国882のドミノ・ピザ全店舗で開始した。	製品化・サービス化
名古屋エアゾール株式会社のPR・販売会社である株式会社メイゾルは、"爪まで丁寧に育む"をコンセプトとした、ハンド&ネイルケアシリーズ「寧寧」のシリーズ第二弾として、爪やその周辺の特に、"荒れや乾燥"、が気になる部分を集中ケアするネイル用保湿パック「、寧寧、ネイルケアパック、」を、2022年3月1日より自社販売サイトにて販売開始いたします。	製品化・サービス化
ASMLは、シリコンウエハーの基板上に集積回路のパターンを焼き付ける半導体露光装置のトップ企業。	
東京ガスは2月24日、横浜市、三菱重工グループと共同で、ごみ焼却工場の排ガス中に含まれるCO2を分離・回収し、CO2を資源として利活用する技術の確立に向けた実証試験を行うと発表した。	製品化・サービス化
クラーケン・ジャパンは19日、日本に居住するユーザー向けの販売所取引サービスに、「Any to Any」と呼ぶ機能を導入したと発表。	製品化・サービス化
詳しくはこちらゆでたマカロニとあえるだけで、おつまみを作れるエスビー食品はマカロニとあえるだけでおつまみを作れる「OTSUMAMI Trattoria」を2月7日に発売する。	製品化・サービス化
Windows Server、でご利用いただけるバックアップサービスとして「定額制バックアップ」の提供を開始します。	製品化・サービス化
100円コンビニ「ローソンストア100」は2022年2月9日、ワンハンドで手軽に食べられるスイーツ新商品「ふわふわシフォンのショートケーキ」税込214円を発売します。	製品化・サービス化
株式会社フォーティーズ株式会社フォーティーズは50歳以上限定の西なびグリーンパス、JR西日本管轄の普通車自由席が乗り放題と当社提携ホテルもしくはお客様がご希望のホテル・旅館などをお手配するプランを2022年1月14日より追加発売開始しました。	製品化・サービス化
同社の精密セラミックボールは、ターボチャージャーや工作機械のスピンドルモーターなどのベアリングに使用されている。	製品化・サービス化
半導体大手キオクシアとクイズ制作集団「クイズノック」は、人工知能を使ったクイズ制作システムを開発した。	製研究・開発
株式会社ジェイテクトは、建設機械・農業機械車両のライフサイクルコストにつながるリマニュファクチャリングへの取り組みを進め、ジェイテクトが持つ寿命予測技術や軸受再組付けが可能となる保持器の開発など、軸受再使用技術を確立しました。	製研究・開発
三菱HCキャピタルは2021年11月、ソフトバンクロボティクスの除菌清掃ロボット「ウィズi」を本社に試験導入した。	製研究・開発
MSIから、LGA 1700に対応するオールインワン型水冷ユニット「MAG Core Liquid 360R V2」が発売された。	製品化・サービス化
カレンダーシェアアプリ「TimeTree」を運営する株式会社TimeTreeは、カレンダー形式でイベント情報を公開・発信できる「TimeTree、公開カレンダー」において、日本プロサッカーリーグ、1部リーグ、18チームの2022年シーズン全試合日程提供をスタートしました。	製品化・サービス化
株式会社エルザ ジャパンは、15.6型モバイルワークステーション「ELSA VELUGA G3-15」シリーズにおいて、SSDの変更などにより価格を抑えたモデルを3月上旬より追加発売する。	製品化・サービス化
DMG森精機は10日、子会社のマグネスケールが、伊勢原事業所内に計測用半導体レーザの新工場を建設すると発表した。	製品化・サービス化
エレクトロニクス機器やソフトウェア製品を開発するシノプシスは3月8日、統合開発環境向けのCode Sightプラグインのスタンドアロン版である「Code Sight Standard Edition」の提供開始を発表した。	製品化・サービス化
吉野川市川島町桑村の食品加工業者おいし工房が、県産スダチを使った「すだちクラフトコーラ」を発売した。	製品化・サービス化
アルファロメオはトナレと呼ばれる新しいクロスオーバーモデルを発表しており、いくつかの異なるパワートレインオプションで米国に登場し、そのうちの1つはブランド初のプラグインハイブリッド使用となっている。	製品化・サービス化
当社は、子供から大人まで幅広い方に役立つプログラミング関連の情報を発信するWebメディア「cody」をリリースいたしました。	製品化・サービス化
パナソニック株式会社は、CATVデジタルセットトップボックスの新ラインナップに、録画可能なブルーレイディスクドライブと500 GBのハードディスクを内蔵したCATVセットトップボックスTZ-BDW900M、TZ-BDW900F、TZ-BDW900Pの3機種を2009年12月より発売します。	製品化・サービス化
シャープは、大阪府枚方市において、中小企業のDX化や生産性向上を目的にクラウド型基幹業務システムを活用した「基幹業務システムシェアリング」実証プロジェクトを開始した。	製品化・サービス化
スマートフォングッズの商品開発、及び通販サイトを運営するHamee株式会社は、世界26カ国で販売されている、保護性能・耐衝撃に優れたスマホアクセサリーブランド「PATCHWORKS」より、AirPods Pro対応「PATCHWORKS SOLIDケース」を2022年1月28日よりHamee、全店で販売開始します。	製品化・サービス化
あいおいニッセイ同和損保と、片道専用レンタカーマッチングサービスを提供するPathfinderは2月4日、レンタカーのドライバーに安全運転を促す実証実験を2月下旬以降に開始すると発表した。	製研究・開発
アイリスオーヤマは、同社初となる「スピーカー搭載、LEDシーリングライト」を、1月15日に発売した。	製品化・サービス化
日本製紙株式会社は、CO2吸収能力が高く成長に優れ、花粉量が少ない等の特徴を持つエリートツリー等の苗生産事業を全国に拡大していきます。	製品化・サービス化
シャープは、美しさと使いやすさを追求したスタイリッシュなデザインと1週間の電池持ちを両立した5G対応スマートフォン「AQUOS sense6」を商品化。	製品化・サービス化
東京都福祉保健局では、都民の生活に身近な福祉保健医療サービスを提供しており、新型コロナウイルス感染症対策など安全に関わる相談も対応しています。	製品化・サービス化
エンブラエル、ウィデロー、そしてロールス・ロイスの3社は2月17日、ゼロ・エミッション型のリージョナル航空機のコンセプトの共同研究を推進する計画を発表した。	製研究・開発
株式会社クロスリンクは複数のSNSの新着投稿をGoogleビジネスプロフィールに自動連携できるデジタルマーケティングツール「SNS Direct」を独自開発してリリースいたしました。	
サミー公式グッズショップ「サミー商店オンライン」は、パチスロ筐体型スマホアクセサリー「ポケパチ」の発売を記念して、公式TWITTERにて、PAYPAYギフトカードが毎日当たるフォロー&RTキャンペーンを、3月1日より開催している。	その他
これによりデータセンタおよびテレコムアプリケーション向けにパワー効率のよい超高帯域EO変換をサポートする。	製品化・サービス化
GiRAFFE&Co.は、レンタルオフィスやシェアオフィス、コワーキングスペースなど、運営会社の独自ルールに基づいて提供される「フレキシブルオフィス」と利用者をつなぐマッチングプラットフォーム「OFiT」を立ち上げ、今春の提供開始を予定している、と発表した。	製品化・サービス化
東北大学大学院工学研究科、東芝は、車載用等の小型モーター向けに、性能は現在と同等で、より継続的に生産を続けられ、さらに安価に生産できる可能性のある新しい等方性ボンド磁石を開発した。	製研究・開発
アルプスアルパインは、自動車のドア等の開閉検出を行うスイッチシリーズにおいて新たなラインナップとなる小型検出スイッチSSCZを開発した。	製研究・開発
内閣官房IT総合戦略室では、デジタル・ガバメント実行計画の一環として「死亡・相続ワンストップサービス」を推進しています。	製品化・サービス化
家電大手が最新商品のサブスクサービスを始めます。	その他
ホンダは、大型アドベンチャーモデル「CRF1100L、アフリカツイン」シリーズの装備を充実させ、1月27日より順次発売する。	製品化・サービス化
ソニー・クリエイティブプロダクツと大井川鉄道は、蒸気機関車の「きかんしゃトーマス号」をゴールデンウィークから運行することを発表した。	製品化・サービス化
バンダイ キャンディ事業部は3月8日、ローソン限定で「食べマス ドラえもん2022」を発売する。	製品化・サービス化
日輪は国際輸送事業で業容を拡大する。	製品化・サービス化
三菱自動車は「アウトランダーPHEV」をベースとしたコンセプトモデル、「ヴィジョン・ラリーアートコンセプト」を東京オートサロン2022に出展。	製品化・サービス化
詳しくはこちら多様な観点からニュースを考えるパナソニックは2023年にも電気自動車用の新型リチウムイオン電池を量産する。	製品化・サービス化
「屋外インフラ用創蓄連携装置」と「マルチアクセスコンセントレータ」のホームページを開設パナソニック システムネットワークス株式会社では、創エネ・蓄エネの機能を持つインフラ設備用リチウムイオンバッテリー「屋外インフラ用創蓄連携装置」と、5GHz無線・Wi-Fi・920MHz特小無線の3タイプのネットワーク構築を一台で実現した無線通信インフラ機器「マルチアクセスコンセントレータ」の販売を開始しています。	製品化・サービス化
株式会社アルマビアンカは「日常でも使用できる」をコンセプトにしたオリジナルグッズを展開する通販サイト、「AMNIBUS」にて「新テニスの王子様」の商品の受注を3月7日より開始いたしました。	製品化・サービス化
MONET Technologies株式会社は、AIデマンドバスの運行を群馬県沼田市内全域で3月25日から開始する。	製品化・サービス化
成型ポテトチップス「プリングルズ」は、2022年の期間限定フレーバー第1弾として「プリングルズ クリームシチュー」を、1月24日に全国発売しました。	製品化・サービス化
日産自動車は、車体の揺れを抑える「e-4ORCE」技術から着想を得たラーメントレイを開発。	製研究・開発
カシオ計算機は、高機能メタルウオッチ「EDIFICE」の新製品として日産自動車のモータースポーツ活動を担う「NISMO」の限定モデルEDIFICE NISMO Limited Edition「EQS-930NIS-1AJR」を、2022年3月4日に発売する。	製品化・サービス化
これからの「成熟社会」における日本の経済成長モデルを作り直すため、地域活性化活動を行う地域リノベーション協同組合は、2022年2月18日より新しい形の"カタログ型"クラウドファンディングサービス「CROFUN」の提供を開始いたしました。	製品化・サービス化
株式会社リアライズは、1月18日〜1月31日までの期間中、アニメ・漫画専門ECサイトであるAnimoで「東京リベンジャーズ、りべんじゃーず、ぶくぶ、セリフアクリルキーホルダー」の予約販売を開始いたします!	製品化・サービス化
KADOKAWAは3月9日、全世界のキャラクターグッズファンに向けた公式オンライングッズストア「EJ ANiME STORE」を、amiami.comとgoodsmileus.comにオープンすることを発表した。	製品化・サービス化
三菱重工グループの三菱重工サーマルシステムズ株式会社は、家庭用ルームエアコンの2022年モデル4シリーズ計23機種を4月1日から順次発売します。	製品化・サービス化
詳しくはこちら発表日:2022年02月16日*キャッシュレス決済の導入から管理まで、ワンストップで提案キャッシュレス決済代行サービス「OmatomeOne」開始大和ハウスグループの大和ハウスフィナンシャル株式会社は、2022年1月26日、事業者向けのキャッシュレス決済代行サービス「OmatomeOne」を開始しました。	製品化・サービス化
クライアントのデジタル領域におけるビジネス課題に対し、最適なソリューションを提供する株式会社モンスターラボは、1月27日に日本郵便株式会社がプレスリリースを行った「e発送サービス、宛先ご指定便」の開発支援を行った。	製品化・サービス化
これまでにも、タップルでは安心・安全の取り組みとして、Media Data Tech Studioの協力のもと「18歳未満の可能性があるユーザーを自動検知するシステム」及び「プロフィール画像において掲載基準に満たない画像を自動検知するシステム」など、機械学習技術を用いた不正利用者の早期検知システムを導入しております。	製品化・サービス化
高速大容量の第5世代移動通信システムを特定の区域や敷地内で導入する「ローカル5G」などを活用し、イチゴ栽培を効率化する実証実験をNTT東日本埼玉支店が埼玉県深谷市の農園で行う。	製研究・開発
詳しくはこちらスマホのマイクやスピーカーを活用したアプリを公開した横浜美術館は14日、コレクション作品を楽しめるアプリを野村総合研究所と共同開発したと発表した。	製研究・開発
サンワサプライ株式会社は、座った際に膝の上でノートやタブレット、スマートフォンの操作を快適に行なえるラップトップテーブル「200-HUS015GY」、「200-HUS016GY」を発売した。	製品化・サービス化
栄研化学、、は8日取引終了後、移動式免疫蛍光分析装置「Exdia TRF、プラス」と、専用試薬であるSARSコロナウイルス抗原キット「Exdia EK、テスト、COVID19Ag」を10日に発売すると発表した。	製品化・サービス化
詳しくはこちら福島県浪江町で地場産品を使った商品開発などを手掛ける「浜のあきんど」は、同町発祥のB級グルメ「なみえ焼そば」用のふりかけを発売した。	製品化・サービス化
パナソニック株式会社、エコソリューションズ社は、「20歳のリフォーム」キャンペーンの一環として、同キャンペーンの期間中にパナソニックの住宅設備建材製品を採用し、リフォームするお客様を対象に優遇金利を適用するリフォーム専用ローン「20歳のリフォーム」ローンの提供を開始します。	製品化・サービス化
株式会社オフィスバスターズはオフィスバスターズデザインのサイトにて、小規模オフィス向けの内装パッケージ「Smooth Office Plan」を2022年2月22日にスタートしました。	製品化・サービス化
ファミリーマートは、刀剣育成シミュレーションゲーム「刀剣乱舞-ONLINE-」に登場する刀剣男士をイメージしたコラボ缶酎ハイの第2弾を本日1月11日より発売します。	製品化・サービス化
Sudioは、アクティブノイズキャンセリング搭載の完全ワイヤレスイヤホン「Sudio E2」を同社公式サイトにて発売した。	製品化・サービス化
ベルキン株式会社は、USB PD対応の充電器「Belkin BOOSTCHARGE PRO 4ポートGaN充電器108W」の先行販売をAmazon.co.jpで開始した。	製品化・サービス化
荷主三菱重工業は20日、三菱重工グループの三菱ロジスネクストと共同で、三菱重工業が研究開発を進める「SynX」のコア技術を適用して物流を知能化・自動化するプロジェクトに着手したと発表した。	製品化・サービス化
用語リンク大百科用語リンク東計電算は2月2日、クラウド型の決済情報管理システム「K-front」の「web明細照会サービス」をパッケージ化し、教育機関向けに4月より提供すると発表した。	製品化・サービス化
株式会社アルマビアンカは「日常でも使用できる」をコンセプトにしたオリジナルグッズを展開する通販サイト、「AMNIBUS」にて劇場版「Fate/kaleid liner、プリズマ*イリヤ、Licht、名前の無い少女」の商品の受注を2月2日より開始いたしました。	製品化・サービス化
NECとKNIは、AI技術などICTを活用して医療の質の向上と業務の効率化を目指す「デジタルホスピタル」の実現に向け2017年より共創を開始しており、今回の取り組みはその一環で実施しています。	製品化・サービス化
同署ではコロナ禍での非接触型情報発信ツールとして、警察官らが市内巡回中に防犯や交通安全啓発チラシをポスティングするなどの活動を行っている。	その他
JR系の研究機関はコストを大幅に削減した送電線を開発し、送電時のロスがほぼない技術「超電導送電」の実用段階に入りました。	製研究・開発
株式会社BEDOREは、三井住友海上火災保険株式会社に対し、自動音声対話エンジンであるAI SaaS「BEDORE Voice Conversation」の提供を開始します。	製品化・サービス化
パナソニック モバイルコミュニケーションズ株式会社は、株式会社NTTドコモへ携帯電話機docomo STYLE seriesTM P-06Aの納入を開始しました。	製品化・サービス化
詳しくはこちらファミリーマートは1月下旬に軽量化したプラスチック製フォークを導入する。	製品化・サービス化
福岡市西区のマリノアシティ福岡で、再生可能エネルギーを活用した実証実験が行われています。	その他
東急リゾーツ&ステイが長野県信濃町で運営する「タングラムスキーサーカス」は、地元須坂市の伸商機工と業務提携しタングラムのロゴが入ったコンパクトで機能的な「オリジナル焚火台」を2月22日に販売開始した。	製品化・サービス化
ノーリツプレシジョンは、画像認識人工知能を用いた肉用牛の分娩検知システム「牛わか」を展開する。	製品化・サービス化
肥薩おれんじ鉄道は、2022年2月22日の「猫の日」を記念した切符を同日発売する。	製品化・サービス化
全国で約10万戸を管理する旭化成ホームズは2月22日、健康寿命の延伸を支援する入居者向けサービス「安心・安全・健康長寿応援メソッド」の提供を発表した。	製品化・サービス化
牛めし・カレー・定食でお馴染みの「松屋」は、2月15日から豚キムチ鍋を販売中です!	製品化・サービス化
ADAPTER INC.は、食品業界の自主マーケティングリサーチ活動を効率化し、これまで社員個人が保有していたデータを社内にオープンにして、社内全体で情報共有を推進するサービス「FDC」のスマートフォンアプリ...	
プラスは、"いつもカドで消す感触"のロングセラー消しゴム「エアイン」シリーズから、フタル酸エステルを使用しない「あんしん仕様」を1月28日に発売する。	製品化・サービス化
CYBERDYNE Omni Networks株式会社、ならびに株式会社コヴィアは、Android搭載IoTデバイス「Acty-G3」のラインアップとして、1,200万画素ワイドカメラを搭載したIoTエッジカメラ「Acty-G3+」を開発しました。	製研究・開発
日産自動車は2月7日、新型「フェアレディ、Z」や、そのカスタマイズプロトモデル「FAIRLADY Z CUSTOMIZED PROTO」を、「大阪オートメッセ2022」に出展すると発表した。	製品化・サービス化
ヴァイテックイメージングは、マンフロットブランドから、一眼カメラ用のバッテリーとその充電器、全5製品を2022年2月25日に発売する。	製品化・サービス化
NECの子会社で、新事業の創出を推進するNEC Xは、人工知能を活用した電子商取引向けのコメント分析サービスを提供する企業、Exponential AI Labsを設立した。	製品化・サービス化
NOBORDER.zと手塚プロダクション,J&J事業創造は本日,NOBORDER.zが開発するメタバース対応型NFTマーケットプレイス「XANALIA」とメタバース「XANA」上のNFTゲーム「NFTDUEL」で使用可能な,地方創生をテーマとしたNFTゲームカードシリーズを発表した。	製品化・サービス化
パナソニック株式会社は、マイクロ波を用いてパワーデバイス、、を制御する電力変換システムを世界で初めて開発し、半導体チップに集積化することに成功しました。	製研究・開発
NHKは、世界初の8K大型自然番組シリーズ「恋する生きものたちの挑戦」をBS8Kで16日から放送開始する。	製品化・サービス化
サンゲツは、4月1日受注分から壁装材、床材、カーテン、椅子生地、副資材を値上げする。	製品化・サービス化
秋田市の企業と秋田県総合食品研究センターがこのほど、秋田杉の葉の成分を配合した除菌スプレー「杉の雫」を共同開発した。	製研究・開発
ロッキードはエアロジェットの推進システムを内製化する予定だったが、合併撤回により米国の防衛に不可欠な極超音速兵器の開発が難航する。	
ソニーマーケティングは、映画「スパイダーマン:ノー・ウェイ・ホーム」とコラボレーションしたワイヤレスヘッドフォンおよびハイレゾ対応ウォークマンの注文受付を開始した。	製品化・サービス化
自動車部品の試作品を製造するタキオンは、小型薫製器を開発した。	製研究・開発
Supership株式会社とKDDI株式会社は、共同運営するSMS送信サービス「KDDI Message Cast」を、新型コロナウイルス感染者への連絡手段として効果的に活用頂くため、お申込みいただいた即日からSMS送信のご利用が可能な全国の自治体および医療機関を対象とした特別プランの提供を開始しました。	製品化・サービス化
「ビストロ」100名サポーターが、スチームオーブンレンジ三つ星ビストロを使って「10分レシピ」を開発。	製研究・開発
ホテル業界が長期滞在型の宿泊プランを相次ぎ打ち出している。	
JR東日本は、乗客がSuicaを利用した際に記録されるデータを、個人が識別されないよう統計処理したうえで、鉄道等のサービス向上に活用するとともに、自治体のニーズに応じた分析レポートをこれまでも提供してきました。	製品化・サービス化
カスタマイズパーツメーカーで、レンタカーやカーシェアリング事業を展開する動きが広がっている。	
コールセンター・バックオフィスの構築・運営を行うセコムグループの株式会社TMJは、在宅コンタクトセンター化に向け設計・構築・マネジメントまでを一気通貫でサポートするサービスとして、「在宅オペレーション」の提供を開始しました。	製品化・サービス化
トヨタカスタマイジング&ディベロップメントは、新型「ノア」「ヴォクシー」の発売に伴い、GRブランドのカスタマイズパーツをラインアップし、1月13日より販売を開始した。	製品化・サービス化
生産人口の減少問題をデータとAIで解決する、株式会社プロトソリューションは、2022年2月2日に、ITデバイスや什器の棚卸し業務の課題を解決する、クラウド型資産管理の自動化システム「カンリス」をリリースいたしました。	製品化・サービス化
日本ハムは7日、自社商品や北海道産の食材を取り扱う電子商取引サイト「ミートフル」を4月上旬から立ち上げると発表した。	製品化・サービス化
経費精算システムのパイオニアであるイージーソフト株式会社は、改正電子帳簿保存法の対応強化や使いやすさを向上した経費精算システム「eKeihi X Ver.15」を2022年3月1日より提供開始します。	製品化・サービス化
米アマゾンは1月20日、同社初となるアパレル専門のリアル店舗「アマゾン・スタイル」を2022年後半にオープンすると発表した。	製品化・サービス化
企業と顧客をつなぐDXクラウドサービスを展開する株式会社ショーケースは、企業と顧客をつなぐあらゆるユーザーインターフェースをSaaSとして実現するプラットフォーム「おもてなしSuite」事業のサービス第2弾として「おもてなしSuite DX」をリリースいたします。	製品化・サービス化
伊勢市の三重県立明野高校生産科学科作物部門が、校内で栽培する米「明高米、結びの神」の輸出に挑戦している。	
松下電器産業株式会社は、株式会社NTTドコモの「iモード」向け公式サイトとして提供している携帯電話向け学習サイト「幸之助de人間力UP塾」の一部コンテンツにおいて、音声と同期したスクリプトを表示するサービスを、10月27日から展開します。	製品化・サービス化
創業初期から、NIMASOは、スマートフォンに関連するアクセサリーの開発販売に力を入れ、ブラントを発展させました。	製品化・サービス化
KDDIは、2月26日〜3月10日の間、自動運転車の移動中の位置情報に連動して変化するARコンテンツをスマートグラス上に表示する「自動運転車と未来のメガネで巡るメタバースの実証実験」を、東京臨海副都心・お台場エリアで実施する。	製品化・サービス化
ランクアップ合同会社は、2.5Gigabit Ethernet対応の拡張カード「2.5GBE-PCE8125B」を発売した。	製品化・サービス化
車載アフターサービスプラットフォームの実現を目指すビズピット株式会社は、自動車整備業者さまが日本の輸出車マーケットにおいて新規事業の基盤構築を行うための支援サービスを開始しました。	製品化・サービス化
株式会社アルクは、英語学習アプリ「booco」の法人・団体向けオンライン自己学習サービスにて、新たに「スピーキングコース」を開講いたしました。	その他
株式会社リンクスインターナショナルは、iCUEで連動、制御ができる160個の、RGB LEDをCORSAIRケースとしては初めて搭載したCORSAIR iCUE 5000T RGBを2022年2月26日より、全国のPCパーツ専門店にて発売いたします。	製品化・サービス化
オーダーメイド枕の店まくらぼは、2017年から横浜F・マリノスを睡眠の観点からサポートし、オーダーメイド枕などの寝具の提供や、アスリートがパフォーマンスを発揮するための睡眠学セミナーなどを行っています。	その他
ファッションとビューティーを軸にブランドディレクション、ODM事業を展開する株式会社レザボアは、コスメブランド「uneven、」より「coloring soft eyeliner thaw」「coloring soft eyeliner accumulate」「uneven eye shadow patience」を発売開始致しました。	製品化・サービス化
メディアスケープは本日,Nintendo Switch向けソフト「ヴァジアルサーガ愚民化戦略XX」の配信をニンテンドーeショップで開始した。	製品化・サービス化
ベネッセは乳幼児や児童にオリジナル教材を一斉に送付するビジネスモデル。	
アンカー・ジャパン株式会社は、リン酸鉄リチウムイオン電池を採用し、一般的なポータブル電源の6倍長寿命を謳う大容量ポータブル電源「Anker 535 Portable Power Station」を発売した。	製品化・サービス化
タケエイのグループ会社である信州タケエイは1月より、廃太陽光パネルのリサイクル事業を開始する。	製品化・サービス化
日鉄エンジニアリング株式会社は、このたびクリーンテックベンチャー企業であるAltum Technologies Oyとライセンス契約を締結し、Deep tech IoT DX技術を活用した、カーボンニュートラルに資する新たなサービス型事業である、プラント設備のスマート洗浄サービスHiPEA EcoFUL2を開始いたします。	製品化・サービス化
パナソニック株式会社、エコソリューションズ社は、パナソニック独自の光のスペクトル制御技術によって、家の中のさまざまな物や場所などを、色鮮やかに照らすLED照明器具「美ルック」を2014年4月より発売しました。	製品化・サービス化
美容脱毛サロンを展開するミュゼプラチナムは、サロン品質のコスメブランド「ミュゼコスメ」から新スキンケアシリーズ"エンラディアンス"を1月17日にローンチした。	製品化・サービス化
中小機構北陸本部、鯖江市、鯖江商工会議所は、持続可能な開発目標への対応を通じた企業の経営課題解決の取組みとして、3機関の連携により、SDGsに貢献する商品の販路開拓支援を開始します。	製品化・サービス化
*、西日本鉄道株式会社は、いすゞ自動車株式会社、三菱商事株式会社、福岡国際空港株式会社と共同で、福岡空港内において大型自動運転バスを用いた自動運転の実証実験を2022年3月8日より実施いたします。	製研究・開発
高崎市は、新年度に電子地域通貨システムを導入すると発表した。	製品化・サービス化
ライフカード株式会社は、本人確認や審査が不要で、コンビニなどで手軽に購入できるネット専用Visaプリペイドカード「Vプリカ」を発行しています。	製品化・サービス化
仏エネルギー大手トタルエナジーズと重工業世界大手ハネウェルは2月17日、ケミカルリサイクル開発で協働すると発表した。	
兵庫県三田市は産後間もない母親を支援するため、家事や育児を手伝うヘルパーを派遣する事業「SUNだっこ応援隊」を始める。	製品化・サービス化
パナソニック株式会社、エコソリューションズ社は、EV・PHEV充電用、充電スタンド「ELSEEVパブリックエリア向け」に、映画「ヱヴァンゲリヲン新劇場版」に登場するキャラクター「綾波レイ」のデザインを施したモデル1機種を、パナソニックのショッピングサイト「Panasonic Store」にて、2014年5月29日より2014年9月30日までの期間限定の受注生産による販売を開始します。	製品化・サービス化
JR東海は3月9日、同社の在来線車両にも車両状態のリアルタイム監視システムを導入すると発表した。	製品化・サービス化
アイシンは3日、埼玉県入間市のイオンスタイル入間で乗合送迎サービス「チョイソコ」を活用した高齢者の外出機会創出による健康増進効果を検証する実証実験を公開した。	製研究・開発
学園ソリューション事業では、学園運営をトータルに支援する学園情報管理システム「キャンパスプラン」を提供している。	製品化・サービス化
リサーチステーション合同会社は、海外最新リサーチ「位置情報サービスおよびリアルタイム位置測位システムの世界市場:用途別、業界別2026年予測」のお取扱いを開始いたします。	製品化・サービス化
フリーランス・副業人材の採用・求人サービス「Workship」を運営する株式会社GIGは、「0からでもわかるジョブディスクリプション作成ガイド」と題した無料のホワイトペーパー提供を開始いたします。	製品化・サービス化
くふうグループにおいて、子ども向け社会体験アプリ「ごっこランド」を展開する株式会社キッズスターは、一般社団法人JFTD花キューピット及び花キューピット株式会社とのコラボレーションにより、2022年3月1日~3月31日の期間、「お花1本プレゼントキャンペーン」を実施します。	製品化・サービス化
GMOインターネットグループのGMOメディア株式会社は、自社の企業独自のポイントサービス構築・運営を支援するポイントCRMツール「GMOリピータス」において、エネルギー業界のポイントを活用したDXを支援すべく、中央電力株式会社と共同でエネルギー業界向けのシステムを新たに開発したことをお知らせいたします。	製研究・開発
東日本旅客鉄道は3月8日、快適な時差通勤を応援する「オフピークポイントサービス」とサブスクリプションサービス「JRE、パスポート」をリニューアルし、本格展開を開始すると発表した。	製品化・サービス化
株式会社ブシロードのグループ会社にあたる株式会社ブシロードクリエイティブは、ギャル雑誌「egg」初のカプセルトイ商品「eggMIXカプセル」を全国のカプセルトイ自販機にて2022年1月13日より順次販売を開始いたします。	製品化・サービス化
Weekly&Monthlyは「笑顔あふれる暮らしづくり」を実現するべく、全国のウィークリーマンション・マンスリーマンション・民泊物件の検索・予約サイト「W&M」と、家具家電付き賃貸専用の検索サイト「LIVLIL」を運営している。	製品化・サービス化
株式会社CARTA HOLDINGSのグループ会社で、小売・飲食業のDX支援事業を展開する株式会社デジクルは、3月14日より、株式会社大創産業の展開する「ダイソー」に、「デジクル、for LINEミニアプリ、」の提供を開始いたしました。	製品化・サービス化
パナソニックグループのパナソニック サイクルテック株式会社は、幼児2人同乗対応電動アシスト自転車「ギュット・シリーズ」の新商品「ギュット・アニーズ」を2013年9月2日より発売します。	製品化・サービス化
日東工業のEV普通充電器「Pit-2G」とENECHANGEが開発したEVドライバー向け専用システムを連携させたサービスを開始した。	製品化・サービス化
同社はストレプトアビジンとビオチンの強固な結合を利用した、次世代のADCの創薬プラットフォーム事業を展開している。	製品化・サービス化
コンビニ大手のファミリーマートとJA全農は11日、関東・関西エリアの同社店舗で青森県産リンゴの販売を始めた。	製品化・サービス化
パナソニック システムコミュニケーションズカンパニー ヨーロッパは、スペインのバルセロナで2015年3月2日〜5日にかけて開催された展示会「モバイル・ワールド・コングレス2015」において、欧州でMVNOサービスを立ち上げたことを発表しました。	製品化・サービス化
日産自動車は、電気自動車向けに開発した次世代製造ラインを米ミシシッピ州にあるキャントン工場に導入する。	製品化・サービス化
ポケモンは、ネモフィラの花をちりばめた青いポケモンたちのグッズ「Baby Blue Eyes」の販売を、ポケモンセンターにて3月12日より開始する。	製品化・サービス化
IT&BASIC Japan株式会社は2022年1月20日から、「新年特別キャンペーン」として、自社開発の企業向け業務性向診断ツール「SYMOFFICE」の無料トライアル及び、社員研修や採用への導入のための無料コンサルティングを実施することを発表致しました。	製品化・サービス化
イー・ラーニング研究所は、インターネットを利用した家庭向けe-ラーニングサービス「フォルスクラブ」、小・中学生向け動画教育配信サービス「スクールTV」などのデジタルサービスに加え、世界で活躍できる力を身につける、小・中学生向け次世代型社会体験教材「子ども未来キャリア」を展開しています。	製品化・サービス化
日本ピザハット株式会社が展開する世界最大のピザチェーン「ピザハット」は、おひとりさま専用ピザセット「MY BOX」が2022年1月12日で全国発売1周年を迎えることを記念して、1月11日より"この冬食べたい「MY BOX」ランキング"1位を獲得し、チーズ好きにはたまらない「ピザ」と「グラタン」をセットにした「グラタンMY BOX」を販売開始いたします。	製品化・サービス化
株式会社メモリアは、2022年3月9日に、コンテンツの世界観を崩さずにNFTを販売できるブランディング型NFTマーケットプレイス「memoria」で、エイベックス・ビジネス・ディベロップメント株式会社と共に現代アーティスト「大橋麻里子」と「三澤亮介」の初NFTアート作品のデジタルコレクションの販売を開始したことを発表しました。	製品化・サービス化
パナソニック株式会社、エコソリューションズ社は、当社独自の「波長制御技術」と「サーカディアンリズム」を応用し、「快適」と「エコ」の両立、そして「知的生産性」の維持を目指した、LED照明によるオフィス市場への次世代省エネソリューションを提案します。	その他
富士通、韓国通信KTと5G検証、NTTドコモが協力、富士通は特定メーカーの仕様に縛られない仕様で通信機器を運用できる「Open-RAN」の導入を共同で進める覚書を、韓国の通信会社KT、NTTドコモと結んだ。	その他
超音波式銀イオン水噴霧器、全国で販売代理店の募集を開始:時事ドットコム、より多くの方に「安心して過ごせる場」を提供したい除菌効果のある銀イオン水の製造・販売を行う株式会社フィットは、人体・物質に害を与えずに空間除菌ができる「超音波式銀イオン水噴霧器」の代理店募集を開始いたしました。	製品化・サービス化
株式会社リアライズは、2月10日〜2月14日までの期間中、アニメ・漫画専門ECサイトであるAnimoで「うらみちお兄さん、缶バッジ付ブランケット」の予約販売を開始いたします!	製品化・サービス化
JR東日本は2022年1月5日から、日立製作所、DXCテクノロジー・ジャパンとの協働で、東京駅八重洲口タクシー乗り場の混雑状況をリアルタイムで配信する実証実験を行っています。	その他
テクノロジーでウェルビーイングの実現を目指すフォレストデジタル株式会社は、没入自然空間、uralaa parkを、大通公園の西端に位置する札幌市資料館にて期間限定でオープンします。	製品化・サービス化
まずエイベックス子会社と提携し、バーチャルアーティストのコンテンツ販売を始めた。	製品化・サービス化
株式会社モトヤは、手書き風書体の新商品としてさらなる文章表現の拡張性を高める「モトヤ角ノート」を発売いたします。	製品化・サービス化
横浜ゴムは2月17日、ホース配管事業強化の一環として、米国およびメキシコの自動車用ホース配管の生産体制再編を発表した。	製品化・サービス化
Blue Danube Systemsは、米国で通信事業者向けに第4世代移動通信システム/第5世代移動通信システム基地局装置の無線機と人工知能ベースの無線機ソフトウェアの開発を手掛けている。	製品化・サービス化
大建工業は、空間の広がりはそのままに、視線をさえぎり、光と風を通す、シンプルでモダンな縦格子デザインのパーティション「格子間仕切」を、11月21日から全国発売いたします。	製品化・サービス化
Fantomは、世界で最も速く、最も環境に優しいスマートコントラクトプラットフォームの1つ。	
キャニオンは西日本最大のスポーツサイクルフェスティバル「サイクルモードライド大阪2022」に出展する。	製品化・サービス化
DINOS CORPORATIONは1月12日、フランスベッドのペット用家具ブランド「フランスペット」のネコステップ付きベッドや、ネコ用タワーパーテーションなど「猫家具」の新商品をディノスオンラインショップで取り扱いを開始したと発表した。	製品化・サービス化
そんななかLINEヘルスケア株式会社は、8つの質問に答えるだけで花粉症のタイプ・重症度が判別できる「重症度チェッカー」を公開。	製品化・サービス化
ソラコムは1月18日、オンラインセミナー・ワークショップ「事例から学ぶ!失敗しないIoTプロジェクトの始め方」を開催する。	その他
県は実証実験として、食べ切れない料理を持ち帰る「テイクアウトボックス」を県内の飲食店に配布している。	製品化・サービス化
株式会社ハムスターは1月19日、同社が運営する同社が運営する「アーケードゲームアーカイブス」において、「ホッピングマッピー」を1月20日に配信すると発表した。	製品化・サービス化
D4エンタープライズは本日,レトロゲーム配信サービス「プロジェクトEGG」の新規コンテンツ「ヴォルガード」の配信を開始した。	製品化・サービス化
ダウ日本は、2019年よりバードライフと小学校での環境教育プログラムを実施。	製品化・サービス化
山善は、同社「Qriom」ブランドから、約10年間ほったらかしでも充電できる「手回し充電テレビ+ラジオ、JYTM- RTV430」を、2月中旬に発売する。	製品化・サービス化
ブルガリアを拠点とするコンセプトデザイナー兼3DデザイナーでもあるEncho Enchev氏は、どんな地形でも移動可能な「モバイルホームコンセプト」を発表した。	製研究・開発
:時事ドットコム テクノロジーによる痛み・不安の軽減を理念とする、株式会社xCuraは、治療体験をエンターテイメント体験に変え、快適な治療体験を提供するXR Therapy"の試験運用を、広島で開始したところお知らせ致します。	製品化・サービス化
株式会社ミヤコシは3月8日、秋田・横手の株式会社宮腰デジタルシステムズで、スタック式水性フレキソ印刷機「MFX57S」の見学会を開催した。	その他
パナソニック株式会社は、AndroidTM、を搭載した企業向けの頑丈なタブレットコンピュータ「TOUGHPAD」の受注を2011年11月16日から開始します。	製品化・サービス化
三井不動産レジデンシャル株式会社は、2022年1月14日に当社初となるホテルライセンス型サービスアパートメント「オークウッドホテル&アパートメンツ麻布」を開業いたします。	製品化・サービス化
数量限定で発売開始「大人の学校給食」:時事ドットコム、栃木の給食やさんの初の試み、栄養バランスと楽しさを両立した惣菜セットの展開「株式会社日本栄養給食協会」は、2022年2月20日よりクラウドファンディングサービス「Makuke」にて、ソフト麺やカレーなどの学校給食の味を家庭で体験できる「大人の学校給食」を限定販売いたします。	製品化・サービス化
米NVIDIAは、ビデオメモリを10GBから12GBに引き上げたGeForce RTX 3080を製品情報に追加した。	製品化・サービス化
ginolaboは1月8日、デッキビルドRPG「SOULVARS」をAndroid/iOS向けにリリースした。	製品化・サービス化
フロンティア、「面接官指名キャンペーン」開始:時事ドットコム、~自分に合う面接官に会いにいきませんか~新ビジネスマッチングサービス「Ready Crew」を運営する、フロンティア株式会社は、2022年3月8日より中途採用において面接官を指名できる、「面接官指名キャンペーン」を開始いたします。	製品化・サービス化
株式会社オーイズミ・アミュージオは本日、国内PlayStation 5向け「プレイグ テイル、-イノセンス-」のパッケージをリリースいたしました。	製品化・サービス化
株式会社SPIQUEでは、自社サービスのオンラインコミュニティプラットホーム「Village」を利用し、初心者でも短期間でプロの動画編集スキルを習得できるオンライン動画スクール「ワクジョイ」の活動とコミュニティ運営をサポートしています。	製品化・サービス化
ステイジアキャピタルジャパンは、、長野県飯山市の「斑尾高原スキー場」を舞台に開催される謎解き宝探しイベント「まだら王国〜雪の王国に伝わる秘宝〜」を、1月15日〜2月13日の期間で開催中だ。	その他
テマセク財団は、Covid-19から住民を守るための第6回配布運動で、シンガポールのすべての住民に再利用可能なマスクを提供する。	製品化・サービス化
株式会社ジャストシステムは12月1日、老舗のワープロソフト「一太郎」シリーズの最新版「一太郎2022」を、2022年2月10日に発売した。	製品化・サービス化
富士通は2月24日、第5世代移動体通信システムのスタンドアロン構成に対応したOpen Radio Access Network仕様準拠の仮想化基地局を開発したと発表した。	製研究・開発
株式会社トラスト・ファイブが運営するライフスタイルマガジン「カーサミア」は、2022年3月18日、電子書籍「一人暮らしをのびのび満喫できるお部屋と出会うための、賃貸マンション・アパートの選び方」を発売します。	製品化・サービス化
ローソンは、神奈川の人気ラーメン店「らぁ麺すぎ本」が監修した「らぁ麺すぎ本監修、塩らぁ麺」を3月8日に発売する。	製品化・サービス化
ICTソリューションの販売・導入およびセキュリティ運用サポートなどを手がける株式会社クロスポイントソリューションは、タニウム合同会社の提供するプロダクトを活用したサイバーセキュリティ・フレームワーク全般を支援する、「X-SOC、端末衛生管理サービス」、の提供を、数多くの海外企業提携によりタニウムのディストリビュータである株式会社マクニカ ネットワークス カンパニーとの協業を基に、2022年1月18日に開始いたします。	製品化・サービス化
ホンダは2050年を目標に、ホンダ車が関係する交通死亡事故をゼロにすることを目標に、さまざまな安全技術を研究している。	製研究・開発
Sheepeaceを運営する合同会社アウトワールドは、洗濯機で洗える消臭サニタリーポーチを2月7日より公式オンラインストアにて販売開始致します。	製品化・サービス化
シャッターチャンスを自動で判断して撮影する、キヤノンの新コンセプトカメラ「PowerShot PICK」の一般販売が2021年11月末に開始されました。	製品化・サービス化
詳しくはこちら旅行会社のクラブツーリズムは鹿島臨海鉄道の協力を受け、同社が茨城県内で運行する貨物線「鹿島臨港線」を特別貸し切り車両で走るツアーを発売した。	製品化・サービス化
いわきFCパーク内の「レッド&ブルーカフェ」は、今年も人気のイチゴを含め、3種類の恵方ロールを予約限定で販売する。	製品化・サービス化
東邦ガスは水素技術を磨きながら、輸送・産業分野でのCN化を支える。	その他
地図AIエンジン開発、地図マーケティングサービス等を提供するData Insight Inc. 、は、飲食店の出店準備支援アプリ、「ジュンビー」、版をリリースしました。	製品化・サービス化
ヤマハ発動機は、スポーツ電動アシスト自転車「YPJシリーズ」の新モデル、グラベルバイクの「WABASH RT」とクロスバイク「CROSSCORE RC」を3月10日に発売する。	製品化・サービス化
「SINN PURETE」は、贅沢に天然由来成分を配合し、ハイブリッドナチュラル処方で植物の力を最大限に引き出した日やけ止めシリーズを新発売することをお知らせいたします。	製品化・サービス化
横浜ゴムは2月22日、スズキのインドにある子会社マルチ・スズキ・インディアが2021年11月に発売した新型「セレリオ」向けに、新車装着用タイヤの納入を開始したと発表した。	製品化・サービス化
JR西日本傘下の日本旅行は、公益財団法人全日本スキー連盟と共同で企画した女性向けスキーツアー商品を販売している。	製品化・サービス化
SKテレコムが人工知能ロボット物流事業を本格的に推進する。	製品化・サービス化
人気アニメ「ガンダム」シリーズをモチーフとしたアパレルのコンセプトショップ「STRICT-G」の新作としてカレッジロゴ風のデザインのスエットが発売される。	製品化・サービス化
無料診断から始めるDX推進! IT部門や情報システム部/担当の課題負荷低減へ:時事ドットコム、~無料で業務負担の低減と改善を診断・支援可能な、サービス、情報システム コンシェルジュサービスをリリース~株式会社エスエヌシーは、業務負荷が高まっている情報システム業務を、知見を持つ経験者が無料診断で最適サービスの提供を行う「情報システム コンシェルジュサービス」をリリースしました。	製品化・サービス化
阿部商会は、「THULE」ブランドの新商品「エッジフィックスポイント」=写真=を発売した。	製品化・サービス化
「ものづくり」にこだわり、衣食住に関わるオリジナル商品を自社店舗で販売しているライフスタイルショップKEYUCAは、春夏にピッタリのキャンバス素材に撥水加工を施したデイリーバッグシリーズ「撥水、エル トートS」「撥水、2WAYエル リュック」「撥水、2WAYエル ミニトート」を2022年2月5日に発売いたしました。	製品化・サービス化
パナソニックマーケティング本部は、新「PEAKS」により、高い動画解像度で静止画だけでなく動画でもくっきり映像を実現するとともに、引き締まった黒、豊かな階調表現力に加え、新開発の「低反射クリアパネル」により外光映り込みを大幅に抑え、明るいリビングでも鮮明な映像が楽しめる地上・BS・110度CSデジタルハイビジョンプラズマテレビ「ビエラ」PX70シリーズ6機種を4月20日より順次発売します。	製品化・サービス化
そしてこのほど、マサチューセッツ工科大学などの研究者が、画期的な海水の淡水化装置を考案した。	製研究・開発
鈴与シンワートは1月20日、Microsoft Teams対応電子印鑑アプリ「Biz-Oin」がMicrosoft Teamsストアからダウンロードが可能になったと発表した。	
SK ICT連合はSKスクエアとSKT、SKハイニックスなどSK 3社がICT融合技術を共同開発・投資し、グローバル進出まで図る。	その他
TISインテックグループのインテックは2月8日、「EDIアウトソーシングサービス」について、製造業特有の受発注情報をWeb画面上で一元管理できる「製造業向け調達Web-EDIオプション」を追加して提供を開始すると発表した。	製品化・サービス化
エースは1月20日より、ビジネスリュック「ガジェタブル バーテクト」を全国の直営店、オンラインストアで先行発売する。	製品化・サービス化
NECは10日、地上で撮影された景観画像と、衛星画像・航空写真を照合することで、景観画像が撮影された場所を推定する技術を開発したと発表しました。	製研究・開発
ヤフーは、スマートフォン向け「Yahoo!、防災速報」の「災害マップ」に、ツイッターに投稿された写真や動画などの災害状況を表示する機能を追加した。	製品化・サービス化
ソフトバンクグループのSBテクノロジーと、サイバートラスト、Qualcomm Technologiesは2022年1月19日、5GとIoTソリューションの開発で協業すると発表した。	その他
パーフェクト株式会社は、12月6日に、コスメデコルテのオンラインカウンセリング、DECORTE Personal Beauty Conciergeでリリースされた肌解析に、先端AI技術を搭載したツール「AI肌診断」機能を提供したと発表した。	製品化・サービス化
三菱電機は1月31日に竣工した「アーバンネット名古屋ネクスタビル」に、サービスロボットと連携するエレベーターと入退室管理システムを納入。	製品化・サービス化
住友ゴム工業は、トヨタ自動車が1月より販売を開始したミニバン「ノア」「ヴォクシー」新型の新車装着用タイヤとして、ダンロップの環境タイヤ「エナセーブEC300+」の納入を開始した。	製品化・サービス化
そうしたなか、東日本の有力スーパーマーケットは、競合店舗の出退店状況や来訪状況をタイムリーに把握できる"チェーン店舗のヘルスチェックアプリケーション"である「HAWKEYE VIEWER」を導入し、自社店舗商圏の防衛に役立てている。	製品化・サービス化
サンワサプライ株式会社が運営している直販サイト「サンワダイレクト」は、Nintendo Switch用の冷却ファン付充電スタンド、「400-NSW011BK」を発売した。	製品化・サービス化
大手ハンバーガーチェーン・マクドナルドで、春の風物詩「てりたま」シリーズの新商品「厚切りスパイシーベーコンてりたま」の販売が9日からスタートした。	製品化・サービス化
マーケティング調査とコンサルティングのヴァリューズは、3C分析が直感的なダッシュボードでできるツール「Dockpit」に、閲覧中サイトの流入数や集客構造をワンクリックで確認できるブラウザ機能「Dockpit lite」を追加して提供を始めた、と2月17日に発表した。	製品化・サービス化
健やかで美しい皮膚を保つためのスキンケアライフスタイルを提案する敏感肌ブランドOSAJIを展開する日東電化工業株式会社、は、今年初となる季節限定の香りシリーズ、スプリングバージョンとして、"Peony"を発売いたします。	製品化・サービス化
ロイヤルカナン、- Yahoo!ニュース ロイヤルカナン ジャポンは、尿中にヘモグロビンが含まれると青く変色し、猫の健康状態を確認できる、猫用トイレに混ぜる顆粒「尿中ヘモグロビンチェッカー」を発売した。	製品化・サービス化
ボルボは2020年12月にVNRエレクトリックを発売。	製品化・サービス化
富士フイルムビジネスイノベーションは2022年1月4日、ERPなどのクラウドサービスであるMicrosoft Dynamics 365をメインに据えた基幹システムの販売・導入支援ビジネスに新規参入すると発表した。	製品化・サービス化
ジャガイモの皮を使用してつくったフレーバーソルトが登場。	
民事裁判IT化の一環として、現在はファクスを使い裁判所や相手方に送る書類を、インターネットの専用サイトで提出できるシステムを最高裁が開発した。	製研究・開発
Collajenneのサブスクリプションプランで、一人一人に合わせたメッセージギフトを添える:時事ドットコム スキンケア・ヘアケアを通して、自分自身と向き合う習慣をお届け株式会社Mirrorlaが「スキンケア・ヘアケアを通して、自分自身と向き合う習慣を一緒につくる」コンセプトのもと、肌と髪のオールインワン・ケアを叶える基礎化粧品「Collajenne」のサブスクリプションプランを開始しました。	製研究・開発
山形空港と庄内空港は3月1日から、それぞれ空港ビル1階ロビーにモバイルバッテリーのレンタルスタンド「ChargeSPOT」を設置する。	製品化・サービス化
藤商事は12月20日、パチンコ遊技機「Pとある科学の超電磁砲」の発売を発表。	製品化・サービス化
両備ホールディングスは13日、車内に星空を投影する「プラネタリウムバス」の運行を始めた。	製品化・サービス化
"アウトドアを通して生活を明るく豊かに"がコンセプトのキャンプ・アウトドア用品メーカー「outstand」から登場した、新感覚LEDライト「エアーチューブライト」が、応援購入サービス「Makuake」にて、2月24日より先行販売中だ。	製品化・サービス化
GROOVE Xは、同社が手がける家族型ロボット「LOVOT」とTSIが展開するゴルフウェアブランド「PEARLY GATES」がコラボレーションし、「PEARLY GATES ESSENTIAL」のTシャツや「パーリーゲイツ」のキャラクターである「フライングラビット」の「LOVOT、ウェア」を発売することを発表した。	製品化・サービス化
オークネットは、サステナビリティポリシーとして「価値あるモノを、地球規模で循環させる~Circulation Engine.」を制定し、あらゆる「価値あるモノ」を「必要な人のもと」へ循環させる"循環型流通"の構築に取り組んでおります。	製品化・サービス化
大創産業は、「メルペイ」「au PAY」を2022年2月1日から、「楽天ペイ」を3月1日から100円ショップのDAISO、新業態のStandard Products by DAISO、THREEPPY、CouCou、Plus Heart2730店で導入する。	製品化・サービス化
生活用品メーカー大手のアイリスオーヤマと、ロボット開発を手がけるソフトバンクグループの子会社が資本業務提携し、飲食店やホテル向けに配膳ロボットの開発・販売を強化することになりました。	製品化・サービス化
東京大学や情報学研究所と企業6社は2月28日、異なる分野のデータ基盤を連携するコネクターと、さまざまなデータ基盤を横断的に検索できるようにする技術を開発したと発表した。	製研究・開発
建設3Dプリンターの開発を手掛けるスタートアップ企業のPolyuseと入交建設が、国土交通省土佐国道事務所の道路改良工事において、3Dプリンターで印刷造形した集水升を設置した。	製品化・サービス化
関西電力は、再生可能エネルギーやワイヤレス充電など、電力需要の少ない時間帯の充電や最適化マネジメントのシステムを開発している。	製研究・開発
同社傘下のベンチャー企業で酸化ガリウムウエハーの開発及び製造販売を手掛けているノベルクリスタルテクノロジーが、昨年12月下旬に酸化ガリウムを材料とする高電圧対応のパワー半導体ダイオードの開発を発表、これがタムラの株価を強く刺激する形となり、ストップ高を交え828円まで急騰する経緯があったが、その後は売り物に押され急反落を余儀なくされていた。	製研究・開発
経済産業省は、二酸化炭素を食べて、たんぱく質や化学品など有用物質を生み出す「水素細菌」の社会実装に乗り出す。	製品化・サービス化
医療廃棄物などを処理する企業が、新型コロナ対応の最前線にいる医療スタッフに野菜の詰め合わせや寿司などを無料で届ける活動を始めました。	その他
東京電力エナジーパートナーは3月3日、新型コロナウイルス感染症による人の移動や活動の制限などにより、売上の低迷や感染防止対策の負担などの影響を受けている経営者・事業者を支援する「TEPCO経営サポート」の取り組みとして、「スマートメーターレポート」を開始したと発表した。	製品化・サービス化
マイクロチップ テクノロジーは、産業用オートメーションネットワーク向けに、低レイテンシーデータトラフィックフローと優れたクロック精度を実現するスイッチングソリューションとしてIEEE準拠の「LAN9668」TSNイーサネットスイッチファミリーの受注を開始した。	製品化・サービス化
詳しくはこちらアサヒ飲料は7日、無糖の炭酸水「ウィルキンソン」シリーズの新商品を3月15日に発売すると発表した。	製品化・サービス化
バルミューダは10日、5Gスマートフォン「BALMUDA Phone」の販売を一時停止すると発表した。	製品化・サービス化
株式会社三井不動産ホテルマネジメント、は、新型コロナウイルスワクチンの追加接種が開始されたことを受け、東京・大阪・京都ほか全17施設の三井ガーデンホテルにて、ワクチン接種予約をされた接種者ご本人およびその付き添いの方にご利用いただける宿泊プラン「ワクチン接種会場ご利用者サポートプラン」を販売しております。	製品化・サービス化
詳しくはこちら大林組はクレーンの作業量や位置情報から施工現場の状況をリアルタイムでデジタル空間に再現し、進捗を一元で管理できるシステムを開発した。	製研究・開発
ユニットコムは1月20日、「iiyama PC」ブランドのゲーミングシリーズ「LEVEL」から、「PSO2、ニュージェネシス」推奨PCを発売した。	製品化・サービス化
Gugenkaは、バーチャルワーカーと企業をつなぐサービス「GUGENKAバーチャルワーク」を開始した。	製品化・サービス化
韓国サムスンが、ラスベガスで開催中のCES 2022にあわせ、「準ハイエンドスペック」となる新型スマートフォン「Galaxy S21 FE 5G」を海外発表しました。	製品化・サービス化
詳しくはこちら西日本シティ銀行は企業向けなどに、利用者からの口座振替の申し込み手続きをインターネットで受け付けられるシステムを構築したと発表した。	製品化・サービス化
エムエスアイコンピュータージャパン株式会社は、12GBメモリ版GeForce RTX 3080を搭載したビデオカード「GeForce RTX 3080 VENTUS 3X PLUS 12G OC LHR」を発売した。	製品化・サービス化
東京・月島にあるショコラトリー「YUNIVERSO」は、2021年11月9日から、宇宙の惑星をイメージした魅惑の本格チョコレート・クレープを販売している。	製品化・サービス化
当社デジタルカメラLUMIXは、2001年よりデジタルカメラ市場に本格参入し、写真画質の追求と共に、簡単にキレイに撮影できるデジタルカメラをコンセプトに、パナソニックならではの幅広いユーザーニーズに応える機能やデザインを備えたモデルを次々と投入して来ました。	その他
パナソニック コンシューマーマーケティング株式会社は、ECサイト「Panasonic Store」のデジタルカメラ・デジタル一眼カメラご愛用者様向けサイト「LUMIX CLUB」にて「フォトレタッチ無料お試しキャンペーン」を実施します。	製品化・サービス化
ウエスタンデジタルは、ゲーム向けM.2 SSDの新製品として前モデルより省電力で高速な「WD_BLACK SN770」を発表した。	製品化・サービス化
リコーグループのメイクリープス株式会社は20日、クラウド型請求管理サービス「MakeLeaps」において、基幹システムなど、MakeLeaps以外のシステムから出力されるファイルフォーマットをそのまま用いて、MakeLeapsへ書類データをインポート可能にする機能「カスタムCSVインポート」を提供開始したと発表した。	製品化・サービス化
鈴与シンワートは、自動車運転者のアルコールチェックや検温などを行い、測定データをクラウドで管理できるサービス「あさレポ」の提供を開始した。	製品化・サービス化
2022年現在アメリカでは、スタートアップのブームテクノロシー社が超音速旅客機「オーバーチュア」を開発しています。	製研究・開発
1日付で、関西みらい銀行、みなと銀行などの持株会社・関西みらいフィナンシャルグループの法人顧客向けにクラウド型健康管理サービス「first call」の提供を開始と発表して好感された上、3日はSMBC日興証券が投資判断を中立の「2」から強気の「1」に引き上げたと伝えられ、買い先行となった。	
東日本電信電話株式会社北海道事業部は、労働力不足の解消並びにコロナ禍における非接触ニーズへの対応のため、入店から商品選択、決済までをスマートフォン等で完結する「スマートストア」店舗を2021年12月20日社内のNTT大通14丁目ビルに開設しました。	製品化・サービス化
EVの企画・開発を手がけるHWエレクトロが、商用EV「エレモ」シリーズで日本のEV市場を開拓する。	製研究・開発
NECは1月4日、警視庁向けに、75歳以上の高齢者が運転免許更新時に受ける認知機能検査時、電話予約に加えスマートフォンやパソコンからインターネットで24時間予約を受付するシステムを構築し、都内の運転免許試験場で運用を開始したと発表した。	製品化・サービス化
NECは11日、創薬の予測モデル構築に関する実証実験で、データを暗号化したまま計算処理ができる秘密計算技術の有効性を確認したと発表した。	製研究・開発
SOICOがCFOに特化した採用支援サービス「CFOパッケージ」を開始:時事ドットコム、SOICO株式会社は、未上場企業向けにCFO人材の採用支援からストックオプションの発行支援までワンストップでサポートする「CFOパッケージ」を開始いたします。	製品化・サービス化
凸版印刷株式会社と株式会社soucoは、物流DX分野における倉庫ソリューション開発での協業に向け、資本業務提携契約を締結した。	その他
ゲーミングデバイスの取り扱いで人気のRazerから、ケースファン「Razer Kunai Chroma」シリーズが発売された。	製品化・サービス化
コロンバスサークルは、「HDMIコンバーター」を2月24日に発売する。	製品化・サービス化
サンワサプライ株式会社は、スタイルに合わせて使い方を選べる3WAYバッグ「BAG-BT3BK」を発売した。	製品化・サービス化
株式会社NewsPicks Studiosは、都内最大級のタクシーモビリティメディア「GROWTH」と連動し経済クイズ番組「QuizPicks」を本日から配信い...	
「ペヤングソースやきそば」を製造する「まるか食品」が、宮城県南三陸町の県立志津川高校の生徒と協力して、ペヤングソースやきそばの新バージョン「たこめし風」と「わさび醬油味」を開発した。	製研究・開発
アイ・オー・データ機器は、最新型のスマートフォン用CDレコーダー「CDレコ6」を3月下旬に発売する。	製品化・サービス化
世界最大の時計企業であるスウォッチ グループ傘下のスイスブランド「オメガ」はクリアスペースと提携し、機能を停止した人工衛星などの宇宙ゴミを回収・除去する事業に参加する。	その他
工事現場の重機による騒音も将来的には消え去るかもしれない、アメリカの建設機械メーカー、ボブキャット社が、世界初の電動ブルドーザー「T7X Compact Track Loader」を開発した。	製研究・開発
Qrioは、スマートロックを通じた、鍵の開施錠や鍵管理の手間や時間解消に加え、2020年12月より「カジタク」を提供するアクティアと提携し、家庭内での時間の節約、ゆとりのある生活の充実を目的に家事支援サービスを提供しております。	製品化・サービス化
マルカサービスは1月19日、VERTEC ONEブランドからエモーショナルなダブルレイヤード25ホイールである「GLAIVE」を発売した。	製品化・サービス化
*真空蒸着法を応用して,ナノメートルレベルで厚さを制御したCOF膜を合成することに成功。	製研究・開発
音符の形の電子楽器「オタマトーン」などの商品開発も行う。	
用語リンク大百科用語リンクFRONTIERブランドでPC等を販売するインバースネットは2月7日、AMD Ryzen 5000Gシリーズを搭載するデスクトップPC「CSシリーズ」を発売した。	製品化・サービス化
エルワイス株式会社は、NPO法人ぷるすあるはと共同制作した、10代向けの事典アプリ「おたすけことてん」を2022年2月7日より提供開始しました。	製品化・サービス化
東京都内および近郊のハイヤーの手配・運行・観光サービスを行う株式会社アウテックは、ご自宅やご希望の場所からドアツードアで観光しながら目的地へ移動ができる「観光ハイヤー」を利用した車いすでも楽しめる「冬のイルミネーション本命馬プラン」の販売をアウテックのホームページにて2021年1月7日より開始いたします。	製品化・サービス化
ヨックモックは、バレンタインにもおすすめの特別なシガール「ショコラ シガール」を2022年1月8日より全国の百貨店にて販売しました。	製品化・サービス化
パナソニック株式会社、デジタルAVCマーケティング本部は、日本語・英語活字カラーOCRソフトの最新製品「読取革命Ver.14」を2月12日より発売します。	製品化・サービス化
メルカリは、全国の100円ショップ「DAISO」約3600店舗で、「メルカリ」で販売した商品が梱包できる「オリジナル梱包資材」を順次発売する。	製品化・サービス化
パナソニック株式会社は9日、IoTソリューション「Vieureka」プラットフォームにおいて、Vieurekaカメラで動作するアプリケーションを出品・購入できるマーケットプレース「Vieureka Manager Marketplace」のトライアル版をリリースした。	製品化・サービス化
エレコムが展開するライフスタイルブランド「LiFERE」の第一段プロダクトとして、同社初の調理家電を発売。	製品化・サービス化
加えて、大手3大通信キャリア以外では初となる、Apple Watch単体でセルラー通信が使える「電話番号シェアサービス」の提供も始まるとのこと。	
国立研究開発法人、産業技術総合研究所ゼロエミッション国際共同研究センター、有機系太陽電池研究チーム、村上、拓郎、研究チーム長、小野澤、伸子主任研究員は、日本精化株式会社と共同で、ペロブスカイト太陽電池に使われる有機ホール輸送材料について、ドーパントと呼ばれる添加剤を使用せず、高い光電変換効率が得られる新規材料を開発した。	製研究・開発
業務用食器・店舗備品の製造販売を手掛けるヤマコーは、今年の創業50周年を契機にした新戦略として消費者向け販売を強化する。	製品化・サービス化
有限会社吉村電材有限会社吉村電材はは、停電時の備えとして、太陽光発電システム蓄電池を販売、設置するサービス「デンデンサポーター」を2022年3月1日より開始いたします。	製品化・サービス化
自転車専門店をチェーン展開する、シナネンサイクル株式会社、株式会社マルナカ、有限会社サイクルショップカナガキ、DAIWA CYCLE株式会社の4社は、各社がインターネットで販売する自転車を相互の店舗で受け取れる、自転車業界初の新サービスを本格的に開始しました。	製品化・サービス化
ダンロップ、プレミアムカー向けグローバルフラッグシップ「SP SPORT MAXX 060+」発売へ、- Yahoo!ニュース、住友ゴムは、高速安定性能・コーナリング性能・ウエット性能を向上させたプレミアムカー向けグローバルフラッグシップタイヤ、ダンロップ「SP SPORT MAXX 060+」を3月1日から順次発売する。	製品化・サービス化
東ソーは11日、熱可塑性ポリウレタンエラストマー製品を今月24日出荷分から値上げすると発表した。	製品化・サービス化
花王は2月28日、Preferred Networksとともに「仮想人体生成モデル」のプロトタイプを開発したと発表。	製研究・開発
カカオ豆の生産・開発から手掛けるフーズカカオ株式会社が展開する、スペシャルティカカオのお菓子ブランド「CROKKA」は、新商品「テリーヌショコラ」の販売を、2022年2月4日より開始しました。	製品化・サービス化
ソニー・インタラクティブエンタテインメントは、PlayStation 5向け次世代VRシステム「PlayStation VR2」と、「PlayStation VR2 Sense、コントローラー」の最終デザインイメージを公開した。	製品化・サービス化
サプリメントの販売・卸を手掛ける日本ファーマは2月21日、男性の肌の悩みにアプローチするスキンケアブランドを立ち上げ、シリーズ第1弾となる化粧水の先行販売をクラウドファンディングで開始した。	製品化・サービス化
株式会社JTBは、埼玉県の川越一番街商業協同組合、京都錦市場商店街振興組合の協力のもと、観光地の食べ歩きによるごみのポイ捨て問題を解決し、SDGsに貢献するソリューション「Go!ME」の実証実験を2022年2月10日~3月10日に実施します。	製研究・開発
ポップでさわやかなアフリカのビーチをイメージしたカラーを採用した、エチオピア発のエシカルなレザーブランドを製造・販売するアンドゥアメットは、アップサイクルコレクション「Shubu-Shubu」のトートバッグ「メイクマイデイ」から、設立10周年を記念したカラーの「アフリカンサーフライダー」を販売している。	製品化・サービス化
L'OREALは美容業界にもっとテクノロジーを取り込もうと、AIお任せのコスメディスペンサーやセルフヘアカラー用ガジェット、ウェアラブル紫外線計測センサーなどのデバイスの開発に、いち早く取り組んできました。	製品化・サービス化
野村不動産は、中央区銀座でPMOシリーズのビルを開発する。	製研究・開発
県福祉人材センターは、福祉の仕事を短期間で経験できる「職場体験事業」を昨年から通年で実施している。	製品化・サービス化
浅草東武ホテルはこのほど、東京都23区唯一のハローキティ ルームと、ハローキティとコラボレーションしたカフェメニューを同時に楽しめるプランを売り出した。	製品化・サービス化
松山市公営企業局は「修繕3東中島地区簡易水道導水管再生工事」の現場でアイスピグ管内洗浄工法を採用した。	製品化・サービス化
当社では一般のお客様向けに、海洋散骨の総合情報サイト「やさしい海洋散骨」を展開しております。	製品化・サービス化
デル・テクノロジーズ株式会社は、ラバーパーツの採用などにより耐久性を高めた教育機関向けChromebook「Dell Chromebook 3110」および「Dell Chromebook 3110 2-in-1」を発売した。	製品化・サービス化
パナソニックマーケティング本部は、HDD搭載ハイビジョンDVDレコーダー「ハイビジョンDIGA」の新シリーズとしてHDD内蔵タイプのDMR-XP12、VHS一体型タイプのDMR-XP22Vの計2機種を2月5日に発売します。	製品化・サービス化
KDDI株式会社、Samsung Electronics Co., Ltd.、富士通株式会社は2022年2月18日、世界で初めて、商用ネットワークに接続するオープン化した5G、スタンドアローンの仮想化基地局によるデータ通信に成功しました。	製研究・開発
慶應義塾大学病院、中部電力株式会社、メディカルデータカード株式会社は、2020年11月20日より慶應義塾大学病院の糖尿病・肥満症外来において、血糖のクラウド管理システムを用いた遠隔診療を支援するシステムの運用を開始しました。	製品化・サービス化
大建工業は8月1日、上面放熱率が床暖房業界最高の90%以上を達成し、40Cの低温水でも快適な暖かさを実現した省エネタイプの高効率床暖房システム<高効率パネル「エコリード」+専用仕上材「サーモタフ」>を発売します。	製品化・サービス化
三重県が新型コロナウイルスの不安解消や感染者の早期発見などを目的にPCR検査キットを無料配布している。	製品化・サービス化
アステリア株式会社は、当社製品AI搭載IoT統合エッジウェア「Gravio」の販売パートナーである株式会社デンセツ工業が提供する「顔認証AIカメラ、搭載、Gravio Enterprise AI Edition」を活用した「徘徊検知ソリューション」を、一般財団法人、児玉報謝会、新成病院が導入したことを発表します。	製品化・サービス化
ソルトンは、独・アイコテック社の革新的なケーブルエントリーシステムの販売に注力している。	製品化・サービス化
株式会社Peer Lodgeは、Zoomで録画された商談が活用されていない課題やなかなか見返す時間が無い課題に対して、時間や場所を選ばずいつでも商談録画や録音を視聴可能にする商談分析SaaS「キクカチ」のWeb版をリリース致しました。	製品化・サービス化
株式会社日本プロパティシステムズは不動産クラウドファンディングを運営。	製品化・サービス化
日本の新しい働き方を創造し、秩父エリアでテレワーク・ワーケーション施設を展開する「オフィスプラス株式会社」は、埼玉県・秩父市からの委託事業として、「秩父テレワーク体験プログラム」を2022年2月28日までの平日限定で実施しています。	製品化・サービス化
コンシューマーマーケティング ジャパン本部は、DLNAクライアント機能を搭載し、「お部屋ジャンプリンク」に対応した「ビエラ」TH-L19C50を2月下旬より発売します。	製品化・サービス化
慶応大は14日、人工多能性幹細胞から変化させた神経のもとになる細胞を脊髄損傷の患者に移植する臨床研究の1例目を昨年12月に実施したと発表した。	製研究・開発
ナスペックは、英オーディオアクセサリーブランド「Blue Horizon」の取り扱いを開始。	製品化・サービス化
信州大農学部は7日、植物資源科学コースの2年生約50人が育てた果物で作ったジャムの販売を構内の科学資料館「ゆりの木」で始めた。	製品化・サービス化
そのもみ殻に含まれるガラスを使い、高い容量と高い耐久性を持つリチウムイオン電池の製造が、最近、欧米をはじめ複数の研究グループより報告されています。	その他
サイバーガジェットは、Nintendo Switch/Nintendo Switchアクセサリーの新製品として、「CYBER・ダブルスタイルコントローラー」を1月20日に発売する。	製品化・サービス化
サンワサプライは1月12日、最大60W出力の2ポートUSB AC充電器「ACA-PD84BK」を発売した。	製品化・サービス化
愛知県の一色うなぎ漁業協同組合と、愛知県水産試験場内水面漁業研究所などがこのほど、通常より2倍の大きさがあるウナギの試験生産に成功した。	製研究・開発
PlayStation VR2は、4K HDR、110度の広視野角、foveated renderingを採用し、より忠実な映像体験を提供するという。	製品化・サービス化
パナソニック デバイスSUNX株式会社は、温湿度・照度を計測し、空調、照明などの最適制御を図ることで、快適性を保ちながら空調、照明の省エネ運転制御をサポートする「ECOnectシリーズ、無線環境センサ」を製品化、2013年12月1日から受注を開始しました。	製品化・サービス化
THE THOUSAND KYOTOは、睡眠に特化した「京都で、GOOD SLEEPプラン」を、2022年4月30日まで販売している。	製品化・サービス化
kanataが、オミクロン株による医療ひっ迫防止を目指し、診察音声認識kanaVoの一部エリアへの無料提供を開始しました。	製品化・サービス化
フォーティネットジャパン合同会社は25日、メールセキュリティ製品「FortiMail、セキュアEメールゲートウェイ」を利用する顧客がオプションとして利用できる、クラウドサンドボックス機能「FortiMail Cloud Sandbox」について、国内データセンターでの運用開始を発表した。	製品化・サービス化
法人会員向けに与信管理ASPクラウドサービスを提供するリスクモンスター株式会社は、2月22日より、iOS及びAndroid向けスマートフォンアプリ「リスモンかんたんコンプラナビ」の提供を開始する。	製品化・サービス化
広島電鉄は、被爆樹木アオギリを車体にあしらったラッピング電車の運行を広島市中心部で始めた。	製品化・サービス化
こうしたDNSが抱える課題を解決し、クラウド接続を自動化、最適化するDNSソリューションが世界中の企業で利用され始めている。	製品化・サービス化
株式会社プレナスは、持ち帰り弁当の「ほっともっと」と定食レストランの「やよい軒」を、2022年2月末現在、国内外に3,112店舗を展開しております。	製品化・サービス化
オムロンは、今後5年を見据えたモノづくり現場の革新コンセプト「i-Automation!-Next」を発表した。	製研究・開発
日本設置台数シェアNo.1の「ChargeSPOT」はモバイルバッテリーを「どこでも借りられて、どこでも返せる」をコンセプトに2018年4月からサービスを開始し、全国の駅、空港、商業施設や飲食店、コンビニエンスストア、公共施設などを中心に現在約30,000ヶ所まで設置場所を拡大しています。	製品化・サービス化
パナソニック株式会社は、新「ナノイーX」を搭載し清潔性をさらに向上させ、業界トップクラスの省エネ性を実現した、オフィス・店舗用エアコン「XEPHYPremium」シリーズを2022年4月より順次発売します。	製品化・サービス化
東京大学大学院新領域創成科学研究科の門城拓、博士課程学生、永澤慧、特任研究員、鈴木穣、教授、鎌谷洋一郎、教授、東京大学医科学研究所の小井土大、特任助教による研究グループは、組織切片画像から空間的な遺伝子発現量をコンピューター上で予測する、深層学習を応用した新規手法DeepSpaCEを開発しました。	製研究・開発
米ヘルスケア大手・アボットのロバート・フォードCEOは、ラスベガスで今月行われた「CES2022」で基調講演を行い、さまざまな生体情報をモニターできる新製品のシリーズを発表した。	製品化・サービス化
コーウェイ・ジャパンは、先日よりタワー型空気清浄機「ハイクラス空気清浄機、NOBLE」の発売を開始した。	製品化・サービス化
詳しくはこちら発表日:2022年01月05日3ステップでかんたん導入ロボットコントローラ、MRC01を新発売オリエンタルモーター株式会社は、「初期設定」「動作プログラミング」「動作確認」の3ステップで、自作ロボットをかんたんに導入・制御できるロボットコントローラを新発売しました。	製品化・サービス化
Acerは、ゲーミングデスクトップPCやゲーミングモニターの新モデルを発表した。	製品化・サービス化
米Texas Instrumentsは、自動車のADAS機器に向けたレーダーセンサーSoCを発売した、ニュースリリース、。	
詳しくはこちらパナソニック子会社、シフトールは1月上旬に開催された世界最大のテクノロジー見本市「CES」で巨大な仮想空間「メタバース」向けのデジタル機器を発表した。	製品化・サービス化
クレディセゾンは2020年11月26日より、女性向けのクレジットカード「セゾンローズゴールド・アメリカン・エキスプレス・カード」の発行を開始した。	製品化・サービス化
アスキーストアでは、普段のスマホ充電とデータのバックアップが同時にできる「PhotoCube Pro」を販売中。	製品化・サービス化
ソニーとホンダは、合弁会社を設立して高付加価値の電気自動車を開発し、2025年に発売すると発表した。	製品化・サービス化
冷食マーケットを運営する株式会社wasyokuは飲食店、、生産者を中心により安心・安全にお使い頂ける「冷食マーケット」プラットフォームを提供することとなりました。	製品化・サービス化
「Solution for Evolution」を企業使命に掲げる総合エンジニアリング・サービス企業のニシム電子工業株式会社と、情報通信商社のサンテレホン株式会社と環境ソリューション企業の株式会社浜田は、この度、浜田にて提供する使用済み中古太陽光パネルを活用した自家消費太陽光発電向けエネルギーマネジメントシステムの開発実証試験を開始いたします。	製研究・開発
「ジバンシイ」が、新スキンケアライン「スキン パーフェクト」を4月1日に発売する。	製品化・サービス化
石屋製菓は、北海道を舞台に冒険活劇が描かれるTVアニメ「ゴールデンカムイ」とコラボレーションし、3月14日に白い恋人36枚入「ゴールデンカムイ」コラボ缶を数量限定で販売する。	製品化・サービス化
ローソンエンタテイメントは同社が運営する「ローソントラベル」で鉄道に関するレアなツアーを企画する新たなプロジェクトを立ち上げた。	製品化・サービス化
用語リンク大百科用語リンク、JAPANNEXTは2月4日より、23.6型のフルHDのゲーミングディスプレー「JN-GT236FHDR165」を発売する。	製品化・サービス化
新型コロナウイルスの感染拡大で学校や保育園の学級閉鎖や閉園が増える中、名古屋市中村区椿町の「焼肉福」が子育て世帯を応援しようと、中学生までの子どもたちが自分で描いた手のひらサイズの絵と、店の焼き肉弁当を無料で交換できる取り組みを始めた。	その他
大阪府枚方市において、中小企業のDX化や生産性向上を目的にクラウド型基幹業務システムを...	
パナソニックグループのパナソニック ストレージバッテリー株式会社は、2012年7月に発売を開始したエコカー用バッテリー「caosハイブリッド車用・caosアイドリングストップ車用」で「日刊自動車新聞、用品大賞、2012、バッテリー部門賞」を受賞しました。	その他
毎日新聞社は2月21日の創刊150年を記念して、映画バーティカル・サイト「ひとシネマ」をスタートさせた。	製品化・サービス化
ASUS JAPAN株式会社は、10Gbps Ethernet対応、PCIeネットワーク拡張カード「XG-C100C V2」を発表いたしました。	製品化・サービス化
テックマンロボットは、協調ロボットシリーズを提供するだけでなく、トータルソリューションの開発に努めています。	製品化・サービス化
株式会社ウッドワンは、全国のショールームで3Dプランニングソフトの「ONE'S PLANNER」を導入し、お施主様がマイホームを新築、改装する前に、インテリア空間をビジュアルで体感できるサービスを6月1日より本格運用を開始いたしました。	製品化・サービス化
MUJIUR団地リノベーションプロジェクト:時事ドットコム、収納機能が充実した賃貸住宅が登場、新シリーズ「MUJIUR Plan+S」をスタート独立行政法人都市再生機構と無印良品の住空間事業部門を担う株式会社MUJI HOUSEは、平成24年度より、関西において「MUJIUR団地リノベーションプロジェクト」を開始し、平成27年度には首都圏から九州まで全国展開してきました。	製品化・サービス化
ソニー・インタラクティブエンタテインメントは9日、PlayStation 5のシステムソフトウェアベータプログラム第2弾を開始する。	製品化・サービス化
ニューイノベーションズは、無人カフェロボット「rootC」で2022年8月期に約50台、23年8月期に同100台の展開を目指す。	製品化・サービス化
HIOKIは、LIB生産ラインの品質検査で潜在不良を検出できる計測器3製品について、発売に先駆け、先行情報を特設サイトで公開する。	製品化・サービス化
トップネット・科学、関西電力は1月13日、5G・Wi-Fiスポット機能やカメラ、街路灯、デジタルサイネージなどを搭載した「スマートポール」の実証実験を始めた。	製研究・開発
JCOM株式会社は、2022年3月1日より新サービス「Smart Art Frame」を東京都、神奈川県、千葉県、埼玉県の法人を対象に開始します。	製品化・サービス化
日立グローバルライフソリューションズは、外出先からスマートフォンで冷蔵室内の中身を確認できるカメラを搭載した大容量冷蔵庫「まんなか冷凍、HXCCタイプ」を2月24日に発売する。	製品化・サービス化
パナソニックは、青森パナソニックねぶた会に対してLED電球を約1900個提供し、青森ねぶた祭りの「パナソニックねぶた」において100%LED化を実現しました。	製研究・開発
京都府は8日、舞鶴港で進めている水素を使った燃料電池フォークリフトの実証事業を報道関係者に公開した。	製品化・サービス化
ベステイト運営の福岡市博多区にあるライフスタイルホテル「モンタン博多」では、毎週金曜日に手作りのワッフルとハンドドリップコーヒーを販売するポップアップストア「NOKISTA」を開催中だ。	その他
パナソニック株式会社は、独自の高指向性ビーコンと、高精度自律航法及び高精度マップマッチング技術注3を応用することで、GPS注4電波が届かない建物内や地下街でも高精度な位置情報を提供する「高精度屋内外位置情報ソリューション」の提供を9月より開始します。	製品化・サービス化
新興出版社啓林館は、教材・児童書ブランド「文研出版」で、新課程用、高校教科書ガイドを3月14日より順次発売します。	製品化・サービス化
CRAYONでは、エンタメ業界向けの公式アプリ開発サービスを提供しています。	製品化・サービス化
注文住宅設計、施工のトータテハウジングは10日、パズルのように間取りのピースを組み合わせて設計する注文住宅の新サービスを発表した。	製品化・サービス化
国立大学法人、京都大学と公益財団法人、日本漢字能力検定協会は、2022年1月25日に、無料の作文学習アプリ「いちまるとはじめよう!ことばむすび」の配信を開始しました。	製品化・サービス化
TD SYNNEXは、国内外の製品やサービスを組み合わせて付加価値を高め、ユーザー企業の課題を解決するソリューションを提供するソリューション・アグリゲーターとなる。	
日本電気株式会社は6日、5GやAI、4Kカメラ映像などの先進技術を活用して、交差点の交通状況測定やインシデント検知に向けた実証実験を開始すると発表した。	製研究・開発
日本生活協同組合連合会は2月8日、資源活用に取り組む「コープサステナブル」「リサイクル材使用」シリーズから「CO・OP再生PET使用つめかえボトル500ml用」を発売すると発表した。	製品化・サービス化
総務省が所管する地方公共団体情報システム機構は26日、マイナンバーカードを使って、コンビニで住民票など証明書を交付するサービスが各地で一時利用できなくなっていると明らかにした。	
ジムニー専門店として知られる"アピオ"から、JB64W/JB74W型ジムニー&ジムニーシエラ用ホイール「WILDBOAR Ventura」が発売された。	製品化・サービス化
3社は新会社を設立、金融デジタルプラットフォームの提供を加速する。	製品化・サービス化
Blu-ray/DVDコピー/変換/作成、動画変換、iOSデータ復元/転送などソフトの開発・販売を行うLeawo Softwareは、お得なキャンペーン「Leawo、卒園・卒業記念思い出作り応援キャンペーン」を2022年3月1日より開催したことをお知らせいたします。	その他
同時に、顧客の住宅事情やニーズに合った照明器具の選定と、そのレイアウトを提案するサービス「あかりプラン」もスタート。	製品化・サービス化
エースホームはFCブランド「HUCK」において新商品、HUCK COASTの販売を開始した。	製品化・サービス化
エレコムは1月11日、VRデバイス「Oculus Quest 2」のレンズに貼り付けてキズから守る高光沢フィルム2製品を発表した。	製品化・サービス化
米カリフォルニア州サンタクララ---- --、モノのオーディオ分野のリーダーでAudio Weaver開発プラットフォームを作成したDSPコンセプトは、待ち望まれていた完全ワイヤレス・ステレオイヤホン向けツールキットの提供を開始したと発表しました。	製品化・サービス化
1965年創業の老舗革製品ブランド・土屋鞄製造所から、革をチョコレートに見立てたレザーチョコレートコレクションが、2022年1月13日から限定発売される。	製品化・サービス化
ライフカルチャープラットフォーム「北欧、暮らしの道具店」において、雑貨や衣類などの開発・販売、メディア運営などを行う株式会社クラシコムは、累計3万2千本を販売する「春いちボトムス・秋いちボトムス」シリーズから、「春いちボトムス2022」を2月17日に新発売します。	製品化・サービス化
当社が提供するKuバンド衛星ネットワークは、商用航空路の99.6%以上でブロードバンド通信及びグローバルライブテレビ放送といったサービスを提供しています。	製品化・サービス化
JR東海は9日、バイオディーゼル燃料を用いた車両の走行試験を報道陣に公開した。	製研究・開発
楽天モバイルは2月28日より、OPPO製5Gスマートフォン「OPPO A55s 5G」にソフトウェアアップデートの配信を開始した。	製品化・サービス化
8団体は、18年から国立研究開発法人新エネルギー・産業技術総合開発機構が管理法人として運営を支援する内閣府「戦略的イノベーション創造プログラム第2期」で採択された「ビッグデータ・AIを活用したサイバー空間基盤技術」の研究開発を推進してきた。	その他
サンコー株式会社は、うつ伏せの姿勢でのスマートフォン操作やゲームプレイに好適という「うつぶせ寝クッションZ」を発売した。	製品化・サービス化
ベネフィット・ワンは、11,341団体、会員約863万人に対して、レジャー施設や、介護・育児サービス、e-ラーニング、オンラインフィットネスなど140万件以上のサービスが優待価格で利用できる会員制福利厚生サービス「ベネフィット・ステーション」を提供しています。	製品化・サービス化
ミネベアミツミ株式会社は専用スマートフォンアプリ「SALIOT」を使って美しい光を思いのままコントロールできるスマートライティング機器「SALIOT S3シリーズ」を、2022年2月より発売いたします。	製品化・サービス化
大正製薬は、乾燥肌のメカニズムを研究したスキンケアブランド「アドライズ」から、1年中乾燥が気になる超乾燥肌の人向けに、寝ている間のスキンケアに着目したスペシャルアイテム「アドライズモイスチュアナイトジェル」を新発売した。	製品化・サービス化
ビービットは、2000年の創業以来、「デジタル時代の本質はUX」であると考え、日本および中華圏のクライアント企業に対し、UXコンサルティングサービスを提供してきました。	製品化・サービス化
同社は24日、業界最小・最軽量クラスを実現した3軸加速度センサー「NP-3550」を発売すると発表しており、これが材料視されているようだ。	
フォードのEVピックアップトラック、住宅の電源に...最長3日間、|、自動車情報サイト、- carview!、フォードモーターは2月2日、EVピックアップトラックのフォード「F-150ライトニング」に、住宅に電力を供給する機能を採用すると発表した。	製品化・サービス化
IoTプラットフォームの開発・提供などを手掛けるジャスミー株式会社は、昨年3月15日に発表したセキュアPCコンセプトを実現したアプリケーション「Jasmy Secure PC」に、機能を充実させた"エージェントPRO"およびエージェントを管理する"マネージャー"の2種類のアプリケーションの販売を開始しましたのでお知らせいたします。	製品化・サービス化
リコーは、「RICOH、証憑電子保存サービス」を提供開始した。	製品化・サービス化
株式会社ユーキャンの通販ブランド「ココチモ」は、人の声やテレビの音がハッキリ聞こえるようになるポケット型集音器「みみ楽」の全国キャンペーンを開始しました。	製品化・サービス化
「CBDを活用し、アルコールダイバーシティを実現する」をミッションとするC-position株式会社は、クラウドファンディングサイト「Makuake」にてCBD商品史上最高金額を達成したCBD配合スパークリングリキュール「BECHILL」を、本日2022年2月10日より自社ECサイトにて販売開始いたしました。	製品化・サービス化
サントリー食品インターナショナルは、牛乳で割ることでフルーツオレが作れる栄養機能食品「ボス カフェベース、贅沢フルーツオレ」を8日発売。	製品化・サービス化
不動産、レンタカー事業などを展開するグッドライフは、冷凍の馬刺しなどを扱う24時間無人販売店のFCに参画した。	製品化・サービス化
カリコ氏らは、メッセンジャーRNAという遺伝物質を使った新しいタイプのワクチン開発に絡む成果を上げた。	その他
ミルウォーキーツール・ジャパンは、高性能HEPAフィルターにより、25g/m3までの粒子を集じんできるツール「M18 26mm集じんアダプター」を2022年2月に発売した。	製品化・サービス化
メルカリの研究開発組織、「mercari R4D」は1月28日、2月から新たに社会人博士支援制度「mercari R4D PhD Support Program」を導入することを発表した。	製品化・サービス化
読売新聞の記事によれば、防衛省が敵対的なドローンを無力化できる「高出力マイクロ波」兵器の研究開発に乗り出すそうだ。	製品化・サービス化
さらに、世界中の生徒同士のゲームバトルやストーリーベースの学習ができる独自の仮想ゲーム空間「ノバキッド・ゲームワールド」を提供開始しました。	製品化・サービス化
株式会社トラスト・ファイブは、株式会社ビル経営研究所から記事の提供を受け、ビル業界トピックスの配信を開始しました。	製品化・サービス化
ジオン商事が、身長155cm以下の小柄女性に向けたECブランド「シリン」を始動した。	その他
株式会社バリューコミットメントは、ピクチャン「コンビニ証明写真」の印刷用紙を期間限定で合格祈願のデザインにリニューアル。	製品化・サービス化
パナソニック株式会社は、SDカーナビステーション「ストラーダ」の新製品2機種、CN-R330WD/CN-R330Dを2015年4月に発売しました。	製品化・サービス化
シチズンは、シチズンコレクションから「夜桜」をデザインテーマにしたレディスのメカニカルモデルを発表した。	製品化・サービス化
オンデマンド建設3Dプリントソリューションの世界的リーダーである、COBOD、は、建設現場のニーズに合わせて、自分だけの建設用3Dプリンタを構成・設計することができる建設3Dプリンタ用のコンフィギュレーション・アプリ「COBODO Configurator」をリリース。	製品化・サービス化
HENNGE株式会社は、SaaS認証基盤の「HENNGE One」が、株式会社ラクローが提供する打刻レス勤怠管理サービス「ラクロー」に対応したことを発表します。	その他
詳しくはこちら貸会議室大手のティーケーピーは2月28日、経済同友会の会員企業を対象に新型コロナウイルスワクチンの3回目職域接種を始めた。	その他
2022年2月25日、リンクスインターナショナルは、ハイエンドモデルのポータブルゲーミングPC"AYA NEO NEXT Pro"の予約をAmazonなどで開始した。	その他
「熟成地焼き製法うなぎ」を開発。	製研究・開発
エアビーは空き家などの物件を持つ「ホスト」と宿泊先を探す「ゲスト」をオンラインでマッチングさせるサービスを展開している。	製品化・サービス化
富士フイルムビジネスイノベーション株式会社は1日、ドキュメントハンドリングソフトウェア「DocuWorks」で培ったノウハウをもとに、クラウドサービス「DocuWorks Cloud」を開発したと発表した。	製研究・開発
パナソニック株式会社ホームアプライアンス社は、国内家庭用において業界で初めて1「ふきこぼれ」「こげつき」お知らせ機能2を搭載したIHクッキングヒーター12機種を6月21日より、パナソニック電工株式会社住建マーケティング本部から順次、販売を開始します。	製品化・サービス化
イオンは2月10日より順次、「イオン」「イオンスタイル」約240店舗1)とイオンの公式通販「イオンスタイルオンライン」にて、やさしい肌ざわりのレディス肌着「トップバリュ、保湿加工インナー」16種類を新たに発売します。	製品化・サービス化
詳しくはこちら日本通運は2022年度から中型の電気トラックを導入する。	製品化・サービス化
トヨタの北米法人は、ピックアップトラックの新型「タンドラ」に初となるラグジュアリーグレード「キャップストーン」をラインナップすることを明らかにしました。	その他
大阪・北浜の地で多くの人を虜にし、ミシュランガイドにも掲載されたカレーの人気店「コロンビア8」は、キーマカレーをはじめ、個性豊かなスパイスカレーを展開している。	製品化・サービス化
株式会社内田洋行グループ、株式会社ウチダ人材開発センタは、製造業や物流業、食品メーカーなど多くの企業様からのご要望を受け、社内のDX化を推進できる新卒社員を育成する「DX人材育成コース」を新規開講します。	その他
サムスンは3日、CES 2022にあわせて最新のミニLEDテレビ「Neo QLED」やディスプレイ「MICRO LED」とともに、テレビ上でNFTの売買ができる「NFT Platform」を発表した。	製品化・サービス化
ティアックから、デスクトップでハイレゾ音楽を楽しめるコンパクトサイズのUSB DAC/プリメインアンプ「AI-301DA-Z」が、1月29日に発売される。	製品化・サービス化
福岡市とトヨタ自動車は、水素をエネルギーにして走る燃料電池車両の実用化や普及に向けた連携協定を結んだ。	その他
愛媛県立小松高校とコンビニエンスストア大手のローソンが、県産伊予カンを使ったシュークリームと、県産「清見」を用いたデニッシュを共同開発した。	製研究・開発
プラス株式会社は、テープの長さを8mから10mに25%増量したテープのり「ノリノビーンズ」を2022年2月22日にリニューアル新発売します。	製品化・サービス化
特定非営利活動法人チームふくしまは、新たな取り組みとして、福島県内の子ども食堂を応援できる、ひまわり油を使った「ひまわりカレー」を3月11日より発売いたします。	製品化・サービス化
パナソニック株式会社は、「「感動」「わくわく」の旅さきフォトコンテスト」の第3弾を、2016年1月14日~2月29日まで開催します。	その他
ミシュランは1月24日、ラスベカスで同月開催されたコンシューマーエレクトロニクスショーにおいて、Eカーゴ・トライク用エアレスラジアルタイヤ「ミシュランXトゥイール」のプロトタイプを発表したことを発表した。	製品化・サービス化
ユニバーサル・スタジオ・ジャパンは7日、人気作品「進撃の巨人」と「美少女戦士セーラームーン」を題材にしたアトラクションを3月4日から8月28日までの期間限定で導入すると発表した。	製品化・サービス化
愛媛大学学術支援センターの武森信曉講師は、かずさDNA研究所との共同研究により、質量分析のためのサンプル前処理の時間を大幅に短縮する画期的な手法「AnExSP」を開発しました。	製研究・開発
ファーストペンギンは、太陽光で充電できる折り畳み式テーブル「ソーラーテーブル」をオンラインストア「Newie」にて発売を開始した。	製品化・サービス化
四国電力は18日、伊方原発3号機のプルサーマル発電で使用するプルトニウム・ウラン混合酸化物燃料24体をフランスで新たに製造する方針を発表した。	製品化・サービス化
小田急電鉄はきょう20日、小田原線下北沢駅の隣接地に、ラウンジやミニシアターなどが入る複合施設「lounge」と、飲食などの路面店2店舗をオープンする。	製品化・サービス化
くら寿司は3月7日から、「くら寿司、原宿店」で、店内にある「スイーツ屋台」が提供するクレープなどのメニューのテークアウトを開始する。	製品化・サービス化
Lenovoは5日、ゲーミング向けノートPC「Legion」シリーズを第12世代Core、および次世代Ryzenプロセッサ搭載モデルに刷新した。	製品化・サービス化
北九州市小倉北区の小倉城で17日夜、城壁や石垣に色鮮やかな映像を投影する「デジタル掛け軸」が披露された。	製品化・サービス化
イカリソース株式会社は、2022年2月17日に新商品「野菜のドレス塩チョレギ風味200」を発売致します。	製品化・サービス化
城山博文堂は、じゃれあう2匹の犬がハンコの外枠になった印鑑「超まる犬はんこ」を1月11日に発売した。	製品化・サービス化
NTTドコモ、個人投資家向け投資管理アプリ「マイトレード」を提供開始、- Yahoo!ニュース、NTTドコモは、個人投資家の投資管理や振り返りに特化したFinTechサービス「マイトレード」を月額550円で提供開始する。	製品化・サービス化
キヤノンマーケティングジャパン株式会社とキヤノンプロダクションプリンティングシステムズ株式会社は、キヤノンプロダクションプリンティングホールディングB.V.製のインクジェット方式の商業印刷向け枚葉印刷機「varioPRINT iX 3200/2100」を2022年4月1日より発売します。	製品化・サービス化
詳しくはこちら前橋市内に2店舗を展開する和菓子店「なか又」は、パッケージにだるまの絵がデザインされた「祈、必勝だるまわもち」を発売した。	製品化・サービス化
香川県は、「ヤドンパラダイス、in、香川」の特別企画で県内で見られるヤドンデザインをお披露目した。	その他
株式会社網屋はこの度、ログを活用したセキュリティ運用サービス「Security Supporter」をリリース致しました。	製品化・サービス化
メーカー家電販売会社は、新型コロナ感染防止対策が3年目を迎える中、電器店にウィズコロナでの販促策や新商品研修などを提案してきた。	その他
ポリゴンはイーサリアムのスケーリングソリューション等を開発・提供するプロジェクト。	
Dynabook株式会社<本社:東京都江東区、代表取締役社長、兼、CEO:覚道清文>は、2022年1月26日、オンラインイベント「dynabook Days 2022 Spring」の中で、マスコミ向け新商品発表会を開催し、最新の第12世代インテル、CoreTM、プロセッサーを搭載したハイブリッドワークに適した至高の14型モバイルノートPC、「dynabook Rシリーズ」を発表した。	製品化・サービス化
ドルチェ&ガッバーナは今後、動物の毛皮の使用を廃止し、エコファーのアイテムやアクセサリーを製作していく。	製品化・サービス化
同社は電子マネーやクレジットカード、QRコードなどの決済手段を一元的に小売事業者などに提供している。	製品化・サービス化
QNAPの正規代理店であるフォースメディアは、ネットワーク機器の新機種として、超高速25GbEファイバーマネージドスイッチ「QSW-M5216-1T」の販売を開始した。	製品化・サービス化
パナソニック株式会社は、会議や講義の録音、語学学習などのおけいこにも役立つICレコーダーRR-XS460/RR-XS360を10月15日より発売します。	製品化・サービス化
映像の企画から制作、映像編集、配信・流通に至るまでを、グローバルにワンストップでお届けする株式会社IMAGICA GROUPのグループ会社で、放送/映像関連機器の開発・製造・販売・輸出入を手掛ける株式会社フォトロンは、高品質・低遅延、映像伝送/共有クラウドサービス「Photron Live Cloud Service」のサービス提供開始に際して、任意の利用開始日から2週間無償でサービスをご利用いただける「「Photron Live Cloud Service」無償利用キャンペーン」を2022年2月14日より実施します。	製品化・サービス化
パナソニック株式会社は、地上デジタル放送規格に準拠し、RFチューナを統合した4ダイバーシティ対応DTV復調LSIを業界で初めて1シングルチップにて開発、2013年12月よりサンプル出荷を開始します。	製品化・サービス化
シンガポールの南洋理工大学からスピンオフした企業であるEureka Roboticsは、産業用ロボットが微細な物を人間の手とほぼ同じ感度で機敏に扱えるようにする技術を開発した。	製研究・開発
オフィスプラス株式会社は、同社が埼玉県秩父市で展開するワーケーションのサービスブランド「えらべるしごと場、秩父、de work」のポータルサイトを開設した。	製品化・サービス化
プログラミング教育事業の株式会社ポリゴンハウスはこのほど、完全無料でご利用いただけるプログラミング学習サービス、「novoc studio」をリリースいたしました。	製品化・サービス化
長野県塩尻市は、2021年10~11月にネットワンシステムズと共同で、物理破壊ではなくデータ消去を行う方法でのプロセスを実証実験で検証した。	その他
詳細画像はこちらメガパワーのEVフラッグシップ、「秘伝のタレ」搭載レクサスは、LFAの精神的後継モデルとなる電動スーパーカーを、2030年までの発売を目指し開発中だ。	製品化・サービス化
東宝株式会社は16日、ゴジラ映画で実際に使われたスーツをベースに、平成シリーズのスーツと同サイズで制作されたゴジラ胸像を、100体限定で商品化すると発表した。	製品化・サービス化
11日付けの日本経済新聞朝刊は、同社が2025年にも木材を原料とするプラスチックの量産に乗り出すと報じた。	製品化・サービス化
KDDIは、スポーツ専門の動画配信サービス「DAZN」がセットになったデータ使い放題の料金プラン「使い放題MAX 5G/4G DAZNパック」を2月下旬以降に提供開始する。	製品化・サービス化
株式会社ポチくるは、ゲームをプレイすると無料で特産品が届くアプリ「ポチくる」の新サービスを、iPhone版アプリでは2021年9月、Android版アプリでは2021年12月より開始しました。	製品化・サービス化
ソフトバンクは、オンライン専用ブランド、「LINEMO、」、において、「PayPayボーナス還元祭」、を実施する。	製品化・サービス化
ファッションとビューティーを軸にブランドディレクション、ODM事業を展開する株式会社レザボアは、メイクアップとファッションの親和性を提案するライフスタイルブランド「ラポドゥジェム」のリブランディングを行います。	その他
アプライアンス・ウェルネス マーケティング本部は、高効率なコンプレッサーと冷却器の開発、さらに業界初2「エコナビ」搭載により、省エネ性を高めたトップユニット冷蔵庫6機種を10月10日より発売します。	製品化・サービス化
株式会社バンダイナムコアミューズメントは、「アイドルマスター ミリオンライブ!、パーソナルパブミラー、北沢志保」を1月18日に発売します。	製品化・サービス化
理研ビタミン株式会社は、2022年2月17日「リケンのノンオイル セレクティ」をリニューアルし、同時に新商品「同すりおろしオニオン」を発売します。	製品化・サービス化
SBI日本少額短期保険株式会社は、不動産業者間流通サービスを提供する株式会社リアルネットプロと、当社賃貸住宅向け保険とのシステム連携に向けた開発を開始いたします。	製研究・開発
エレコム株式会社は、14型ノートPCまで対応可能な吊り下げ式オーガナイザー「PCA-HON01BK」、「PCA-HON01BR」を2月上旬に発売する。	製品化・サービス化
中国、下着の商標まで見える超高解像度全身スキャナを開発=韓国報道、- Yahoo!ニュース、宇宙レーダー技術を利用した超高解像度全身スキャナーが中国で開発されたと、香港紙のサウスチャイナ・モーニング・ポストが14日付けで報じた。	その他
日本ハム株式会社は、今年で発売38年目を迎えるシャウエッセンについて環境負荷低減を目指した「エコ・ピロタイプ」のシャウエッセンを2022年2月1日より新発売します。	製品化・サービス化
株式会社ロックガレッジは、茨城県DXイノベーション推進プロジェクト事業の採択を受けて、茨城西南広域消防本部と合同で、ドローンAIスマートグラスによる訓練形式の人命救助実証試験を実施しました。	製研究・開発
世茂集団は居住用不動産やホテル、オフィスなどの商業用不動産を開発し、中国の不動産業界では社債発行が最大級。	
韓国語教育機関の「世宗学堂」を運営する世宗学堂財団は9日、海外での韓国語教育の拡大に向け、オンラインで教材などを貸し出す「電子図書館」サービスを14日から始めると発表した。	製品化・サービス化
1977年よりレトルトおでんを製造している丸善は、あたたかいおでんを食べる機会が少ない春夏の季節にも、日本の伝統的食文化である「和食」のひとつ「おでん」の魅力を発信できるよう、商品開発に励んでおります。	製品化・サービス化
拡張エンタープライズ学習管理システム、 WisdomBaseを運営する株式会社シェアウィズは、同サービスでのシングルサインオン機能の提供を開始しました。	製品化・サービス化
ブルガリは、サステナブルな未来を継続的に作る取り組みの一環として、環境への影響を軽減するという包括的な取り組みを反映した「ブルガリメンズ レザーグッズ コレクション」を発表。	製品化・サービス化
McAfee Enterpriseは12日、企業の経営幹部層を対象にした「経営者向けサイバーセキュリティ集中講座」を提供すると発表した。	製品化・サービス化
イタリアの自動車メーカーのアルファロメオは、最新SUVの「トナーレ」を発表した。	製品化・サービス化
WEBZENは2022年2月23日,スマートフォンアプリ「MU ORIGIN 3」のサービスを韓国国内で開始した。	製品化・サービス化
1908年創業のグローバル刃物メーカーの貝印が、ハンドルに紙、刃体に金属を使用し、従来比98%のプラスチック部分を削減した"脱プラスチック仕様"「紙カミソリ」を、2022年3月22日に全国のローソン店舗で先行発売します。	製品化・サービス化
ヴィレッジヴァンガードは、soup合同会社の「湯たんぽ」をオンラインストアで発売した。	製品化・サービス化
創業97年の老舗米菓メーカー日の出屋製菓産業株式会社は自社直販ECサイト「ささら屋公式オンラインショップ」や全国15店舗のささら屋直営店舗で、富山県産もち米100%にこだわった「ひなあられ」商品を1月20日より発売開始しました。	製品化・サービス化
株式会社10Xは、同社が小売ECプラットフォーム「Stailer」を通じて提供する薬王堂「P!ck and」アプリにて、新たにお客様の自宅までのラストワンマイル宅配を開始します。	製品化・サービス化
NTTドコモなど複数社で構成される電子マネー推進検討会は、キャンペーン「抽選で7,300名様に商品券が当たる!しまむら春の電子マネー祭!」を開始した。	製品化・サービス化
フォルクスワーゲンが新型ゴルフのディーゼルエンジンモデルを日本で発売。	製品化・サービス化
企業ブランディング支援を行う株式会社揚羽は、企業の各拠点での仕事・生活を発信するWebサイト・コンテンツ「地方LIFE WORK」を2022年2月にローンチしました。	製品化・サービス化
エーザイが薬用ザーネクリームを全国3万人の小学生に配布し「手洗い・消毒後のハンドケア1週間チャレンジ」を実施。	製品化・サービス化
Amazonとヤマダホールディングスは17日、両社の全面的協力で開発された、日本国内初、Fire TV搭載の新しいスマートテレビを発表した。	製品化・サービス化
WoltJapanが運営する「Wolt」は、現在22都道府県の38エリアでデリバリーサービスを展開中。	製品化・サービス化
一人暮らしのアラサをターゲットにしたスタイリッシュな生活家電、パナソニック「NIGHT COLORシリーズ」と日本最大級の住宅・不動産情報ポータルサイト「HOME'S」が、「アラサーシングルのお部屋探しで、夜カジ家電が当たる!」キャンペーンを2011年9月1日より実施しています。	製品化・サービス化
一般社団法人MUTEK Japanは、新たに展開する新感覚のアート体験型イマーシブアートエクスペリエンス「ETERNAL Art Space」を2022年3月12日〜20日の9日間、パナソニックセンター東京Aスタジオで開催する。	その他
株式会社日本触媒と大阪大学大学院工学研究科応用化学専攻の宇山浩教授のグループは、様々な素材表面に抗菌及び抗ウイルス効果の付与が期待できるコーティング材料を共同開発しました。	製研究・開発
株式会社BORDERLESS FARMが生産・製造を担い、株式会社インターナショナル・プロデュースは、フェアトレードで仕入れる農薬不使用のハーブを使ったハーブティーを販売するECサイト「WELLFIRM」を2月28日にオープンいたします。	製品化・サービス化
株式会社レイは、この「相棒season20」の番組WEBサイト内で、「特命係」の様々な秘密を知ることができる体験型、3D WEBコンテンツ「360特命係」の制作を手掛けました。	製品化・サービス化
詳しくはこちら法人向け動画マニュアルを提供するsoeasyはスマートフォン動画を活用し、外国人材の日本での就職を包括的に支援するサービスを始める。	製品化・サービス化
居酒屋「餃子家龍」を展開する井辻食産は、ギョーザを出す広島市内の飲食店52店を対象にしたスタンプラリーを開いている。	製品化・サービス化
Connected Industries株式会社は、兵庫県西宮市の市から委託を受ける5施設すべての病児保育室で、2月1日より病児保育支援システム「あずかるこちゃん」の提供を開始します。	製品化・サービス化
ヤマハ発動機は、電動アシスト自転車の新型モデル「WABASH RT」を10日発売。	製品化・サービス化
神戸大学大学院理学研究科の津田明彦准教授らの研究グループは、AGC株式会社と協力して、光で酸化したクロロホルムを使って、スポンジ、クッション、断熱材、繊維などに使用されるポリウレタンやその原料となるイソシアネート、および尿素誘導体の合成に成功しました。	製研究・開発
京都、グランデでは、客室内でフィットネスマシンが使える宿泊プランの販売を開始しました。	製品化・サービス化
三井住友カードは、抽選で1万人に2022円分のVポイントが当たる「2,022ポイントプレゼントキャンペーン」を開始した。	製品化・サービス化
大日精化工業は、酸化チタンを使用した分散液の新製品を開発した。	製研究・開発
2021年、プーマ・モータースポーツは、初めて女性ドライバーのためにレースウェアを製作しました。	製品化・サービス化
関東地方整備局は建設キャリアアップシステムの活用を一段と促す。	その他
合同会社hataoriは、鹿児島県の事業にて、鹿児島県の若者を対象に「ジェンダー平等」をテーマにしたワークショップ「#わたしはわたし」を開催しました。	その他
ソニーストアは、プレイステーション、4用標準ワイヤレスコントローラー「DUALSHOCK 4」の販売を実施している。	製品化・サービス化
株式会社ブシロードクリエイティブは1月13日、「マジで噴き出すトイレ」の発売を発表した。	製品化・サービス化
国立大学法人東北大学大学院工学研究科、株式会社東芝は、車載用等の小型モーター向けに、性能は現在と同等で、より継続的に生産を続けられ、さらに安価に生産できる可能性のある新しい等方性ボンド磁石を開発しました。	製研究・開発
大阪・梅田にある大阪新阪急ホテルの直営ベーカリー「ブルージン」は、ネコの顔をかたどった食パンやスイーツをシリーズ化し「ネコ好きの聖地」と呼ばれる。	その他
スタイルワゴン ドレスアップナビ・チームは、東京オートサロン2022、で360全方位カメラをテスト運用しました。	製研究・開発
株式会社アイ・オー・データ機器は、昇降/チルト/ピボット可能なフリースタイルスタンドを装備した27型液晶ディスプレイ「LCD-DF271ED-F」シリーズを2月上旬に発売する。	製品化・サービス化
メディアドゥの取引網を生かし、書籍や漫画などを展示したり手に取ったりできる仮想空間「メタバース」の提供を構想する。	製研究・開発
全日本空輸、JR東日本、東京モノレール、エムケイは3日、車いすユーザー向け移動支援サービス「一括サポート手配」の社会実装に向けた実証実験を始めた。	製研究・開発
寿司レストランチェーンを展開する元気寿司株式会社は、2月3日の節分の日に向けて、2022年1月25日より「手づくり恵方巻」4種を期間限定で販売いたします。	製品化・サービス化
株式会社ゼンプロダクツはAI文章校正ツールShodoの無料版を2022年1月7日より提供開始しました。	製品化・サービス化
ヤフー、ビッグデータを活用して人の興味関心を可視化する新サービス「DS.INSIGHT Persona」提供開始、- Yahoo!ニュース ヤフーはビッグデータを活用し、人の興味関心を可視化してペルソナを具体化する新サービス「DS.INSIGHT Persona」の提供を開始した。	製品化・サービス化
タケショウ株式会社では本日、口にくわえて数秒間で抗原検査ができる簡易抗原検査キットを発売いたします。	製品化・サービス化
デジタルAVCマーケティング本部は、ステレオインサイドホン、RP-HJE355とRP-HJE255を「DEEP FIT BASS」シリーズとして、10月14日より発売します。	製品化・サービス化
本別町内で居酒屋などを経営する物まねタレント何ン田研二さんが、十勝産小豆を使った「飲む餡」を商品化した。	製品化・サービス化
パナソニック株式会社は、本年3月に発表したセキュリティシステム、i-PRO EXTREME、シリーズの新製品としてネットワークディスクレコーダー、WJ-NX200シリーズを、2017年10月より発売します。	製品化・サービス化
JVCケンウッドは、ケンウッドブランドのドライブレコーダーとして、前後撮影対応2カメラドライブレコーダー「DRV-MR570」と、駐車録画対応電源ケーブル同梱の「DRV-MR575C」を1月下旬に、360度撮影できる2カメラモデル「DRV-C770R」を2月下旬に発売する。	製品化・サービス化
コダックは、ドイツのWKSグループのエッセン市にある拠点に世界1号機となる「KODAK MAGNUS Q4800プレートセッター」の設置を完了したことを発表した。	製品化・サービス化
Microsoft、は、16、日、Windows 11 Insider Preview、ビルド、22557、を、Dev、チャネルで提供開始した。	製品化・サービス化
KDDIがドローン事業を加速させている。	製品化・サービス化
株式会社ロア・インターナショナルは、HACRAYより、ブランド初のハイエンド骨伝導イヤホン「SeaHorse」を国内クラウドファンディングサービス「Makuake」にて、2022年1月31日12:00より先行販売を開始します。	製品化・サービス化
イタリア植物タンニンなめし革協会は1月26日16時半から、ZOOMを用いたオンラインセミナーを開催する。	その他
大人の肌悩みにアプローチするコスメブランド「ドネオ」がデビューし、第1弾アイテムとしてパウダー状美容液「ドネオ ビタソーダ パウダー」が3月1日に登場する。	製品化・サービス化
独ギガファクトリーは、年間で50万台以上のEVや、EV用充電池を生産する能力を持つ。	
カカクコムは2月1日に、同社が運営する購買支援サイト「価格.com」において、スマートフォン料金プランの比較サービス提供を開始したことを発表した。	製品化・サービス化
日本エイアンドエルは、環境意識の高まりを追い風に合成ゴムラテックス事業を高収益化する。	
Verbatim Japanは、テレビアニメ「鬼滅の刃」の登場キャラクターをプリントしたUSBメモリー「名シーン」シリーズ7機種と「名セリフ」シリーズ5機種を、2月より順次発売する。	製品化・サービス化
サイクルパーツブランド「CICLOVATION -シクロベイション-」より、多機能バルブキャップ付き軽量バルブステムが発売された。	製品化・サービス化
エンターテインメント中心のオンラインサロンプラットフォーム「MUSIC.JPオンラインサロン」は、大手声優事務所81プロデュースと、体感型エンターテインメント・コミュニティの運営を3月15日より開始します。	製品化・サービス化
スウェーデンのリンショーピング大学の研究チームは、大量の電力貯蔵を可能にする安全/安価で持続可能な技術の開発に成功した。	製研究・開発
九州・宮崎の老舗魚屋「九州築地」が、「宮崎、-森のチョウザメ-」を使用したサステナブルなペットフードを開発。	製研究・開発
KDDIは、SNSなどウェブを中心に活躍する関西在住の19人のアーティストとコラボした「#大阪環状線をアートでつなぐぞ」企画を開始した。	製研究・開発
大和郡山市は2月1日から、ごみ拾いSNS「ピリカ」を活用したごみ拾いの状況がわかるホームページ「思いをつなぐ、元気城下町」の運用を始める。	製品化・サービス化
2022年3月4日,JAPANNEXTは,24.5インチサイズで解像度19201080ドット,垂直最大リフレッシュレート240HzのIPS互換パネルを採用したゲーマー向けディスプレイ「JN-IPS245FHDR240」を発売した。	製品化・サービス化
コンクリート生産とレアメタル回収などを手掛ける金円環保は5日、子会社によるチベット自治区の塩湖でのリチウム塩生産プロジェクトを発表した。	製品化・サービス化
雪印メグミルク株式会社は、「あじわい減塩チーズ カマンベール入り」6本入りを2022年3月1日より全国にて新発売いたします。	製品化・サービス化
集合住宅向けIoT電動アシスト自転車シェアリングサービスの実証実験を開始:時事ドットコム パナソニック サイクルテック株式会社は、2022年1月から2年間の予定で、集合住宅における居住者向けIoT電動アシスト自転車シェアリングサービスの実証実験を実施します。	製研究・開発
組織・人材開発コンサルティングのインパクトジャパン株式会社は、新入社員の教育担当を対象とする研修「ENCOURAGE」を、2022年も継続して提供することを決定しました。	製品化・サービス化
株式会社ロゴスコーポレーションが展開するアウトドアブランドの「LOGOS」は、デザイン面の新境地を目指した「LOGOS GLAMBASIC」シリーズより、アレンジ自由なヘキサ型タープ「グランベーシック ソーラーヘキサタープ」2サイズと、居住性に優れたレクタ型タープ「グランベーシック ソーラーレクタタープ、L-BB」を2022年より発売いたしました。	製品化・サービス化
「ビール業界のDX」クラフトビールスタートアップBest Beer Japan、シードラウンドで7,000万円を調達:時事ドットコム、Best Beer Japanはクラフトビール醸造所を管理するITツールと物流サービスを運営している。	製品化・サービス化
本認定により、アリオンはWi-Fi CERTIFIED 6TM Release 2認証プログラムおよびコンサルティングの提供を開始いたします。	製品化・サービス化
用語リンク大百科用語リンク、株式会社エヌアイデイは、株式会社Studio Ousiaの開発したSaaS型QAシステム「アンサーロボ」と連携し、学習済みAIでFAQ登録後すぐに利用できるAI FAQ「OHGAI」をリリースしました。	製品化・サービス化
身長150センチ前後の女性に向けたアパレルブランド「COHINA」を手がけるnewnは2月13日、クリーンとモードをテーマにした小柄な大人女性向けの新ブランド「STRATA」を始動した。	製品化・サービス化
LINEでは、企業や店舗が自社のLINEアカウントを開設し、ユーザーにさまざまな情報を配信できる「LINE公式アカウント」や、予約・注文・会員証といった企業の自社サービスを、無償で「LINE」アプリ上にウェブアプリケーションとして提供できる「LINEミニアプリ」など、さまざまな法人向けサービスを展開しています。	製品化・サービス化
LOAD&ROADはスマートフォンアプリと連動して使う「teploティーポット」を手掛けており、象印は製品やサービス、新規事業の共同開発を目指す。	製研究・開発
住友林業は1月27日、フィンランドのOne Click LCA社と、建物のCO2排出量などを見える化するソフトウェア「One Click LCA」の日本単独代理店契約を締結したと発表した。	その他
ねこ車電動化キット「E-Cat Kit」、埼玉県横瀬町と共同で農業と建設業の運搬労力削減に向けた実証実験開始:時事ドットコム、~横瀬町の官民連携プラットフォームに採択され、電動化の可能性を開拓へ~株式会社CuboRexは、埼玉県横瀬町と連携し、一輪車のタイヤを交換するだけで電動化が可能となる、ねこ車電動化キット「E-Cat Kit」を用いた、農業および建設業の運搬労力の効率化に向けた実証実験を2022年2月より開始いたします。	製研究・開発
太陽光発電を活用し、二酸化炭素を出さずに作られる「再生可能エネルギー由来の水素」は、脱炭素化への潮流で注目度が高まっている。	
産直EC、オンライン上の繋がりだからこそできる新サービス「オンライン農園ツアー」を開始。	製品化・サービス化
パナソニック コミュニケーションズ株式会社は、インターネットを利用した通話を実現するSkypeをパソコン無しで利用でき、当社製音声会議ホンとの連携などビジネスに便利な機能を搭載したSkype対応ワイヤレスフォン「KX-WPA300」を各種法人ユーザー向けに10月7日から発売します。	製品化・サービス化
TOKYO FMと株式会社ジャパンエフエムネットワークの音声コンテンツプラットフォーム「AuDee」は、新たにオーディオコンテンツプラットフォーム「マイスタジオ」を開始しました。	製品化・サービス化
七宗町は、豪雨時の河川氾濫から住民の命を守るため、映像で河川の情報を確認できるシステムを導入し、3月10日から運用を始める。	その他
まちづくりに取り組む奄美イノベーションは、離島の奄美大島などで廃業したスーパーやカラオケボックスも生かす新しい地域再生プロジェクトを進め、注目を集めている。	その他
神奈川県は新型コロナウイルスの感染者について、重症化するリスクの低い人が医療機関を受診せずに自ら療養を行う「自主療養」のシステムをあすから全国で初めて開始すると発表しました。	製品化・サービス化
海洋ごみ問題の解決に一役買おうと、名古屋市の繊維会社が海岸に漂着したペットボトルをリサイクルして商品化する取り組みを始めた。	その他
ENDROLLと集英社は、共同開発する睡眠習慣記録をテーマにしたアプリ「よひつじの森」のiOS版を2022年春にリリースすることを発表、事前登録の受付を開始した。	製品化・サービス化
全薬工業は、敏感肌用スキンケアブランド「アルージェ」とサンリオの人気キャラクター「シナモロール」とのコラボデザインボトル「アルージェモイスチャーミストローションII」を、数量限定で発売した。	製品化・サービス化
この度、個人アプリ制作ブランド「チーム・エルフォンス」は、2022年3月8日より、Android向けターンベース、コマンド入力型ロールプレイングゲーム「エクスアルジェント、災厄の女神」の公開を開始致しました。	製品化・サービス化
株式会社SmartHRは、クラウド人事労務ソフト「SmartHR」の新TVCMを2022年2月11日より放送いたします。	製品化・サービス化
「おいしく栄養を摂取して楽しくからだづくりができる時代へ」をミッションに掲げるEVO FOOD/エボフードは、ダイエット中やからだづくりにおいて罪悪感なくおいしく食べられる新たな食文化を志し2021年8月に販売をスタートした栄養生パスタにと組み合わせる完全無添加ソースとして新たに3種類の提供を開始したことをお知らせします。	製品化・サービス化
パナソニック エコシステムズ株式会社の子会社である、株式会社ベンテックは、排気流による住宅の外壁の汚れを低減し、防水性能を強化した換気用フード「ピタンコフード」を2010年4月1日より発売します。	製品化・サービス化
エネルギー分野などを手掛けるインフラ社は、盗聴が不可能とされる「量子暗号通信」のサービス展開を含め、2030年度に2兆5000億円の売上高を目指す。	製研究・開発
三菱ケミカルはサッカークラブのガンバ大阪と連携し、2022年にガンバ大阪のホームスタジアムであるパナソニックスタジアム吹田で開催されるJ1ゲームにおいて、三菱ケミカルの生分解性樹脂「BioPBS」を使用した紙コップを使った実証実験を開始する。	製品化・サービス化
ヤマシタヘルスケアホールディングスは、九州を地盤とする医療機器専門商社を中心にヘルスケア領域でのグループ力向上を推進している。	製品化・サービス化
株式会社マネーフォワードは、2022年の確定申告シーズン到来に先立ち、個人事業主の開業支援サービス「マネーフォワード クラウド開業届」導入促進のための特設ページ「好きを仕事にする、ということ」を開設した。	製品化・サービス化
ローソンが、「タルタルチキンカツ&豚焼肉丼」を2022年2月15日に発売します。	製品化・サービス化
XTech Ventures株式会社は、ベンチャーキャピタルとのシェアオフィス型インキュベーション施設「xBridge - Yaesu」を東京駅八重洲口から徒歩1分の場所にて、2022年4月にオープンします。	製品化・サービス化
化学素材メーカーのADEKAは、台湾の連結子会社である台湾艾迪科精密化学において先端ロジック半導体配線工程向けALD材料の新プラント建設を決定したと2月17日に発表した。	製品化・サービス化
「ポール・スミス」が、「ポーター」とコラボレーションしたバッグやウォレットを2月16日に発売する。	製品化・サービス化
東京海上日動は2月15日から、自動車保険の保険金請求手続きに人の手を介さず、完全自動化する損保業界初のシステムを稼働させる。	その他
無添加調理で商品作りを進めている石井食品株式会社は、神奈川県三浦市・三浦市農業協同組合と連携して、昨年4ヶ月で約35万食を売り上げた「神奈川三浦のキャベツを使ったハンバーグ トマトソース ロールキャベツ風」を今年も販売します。	製品化・サービス化
ヤマダホールディングスは、オリジナルブランド「SERIE NOIR」から「スチームオーブンレンジ、NMW-JV23K」を2月中旬に発売する。	製品化・サービス化
オーイズミ・アミュージオは、プレイステーション5用ソフト「ザ・パーシステンス、ENHANCED」を5月26日に発売することを発表。	製品化・サービス化
パナソニック株式会社は、世界初1の低価格な業務用一体型二眼式3Dカメラレコーダーを2010年秋より発売します。	製品化・サービス化
デジタルクローン生成サービスを本格的に受付開始。	製品化・サービス化
国立大学法人東京大学大学院工学系研究科と、日本電気株式会社は、「Beyond 5G価値共創社会連携講座」を開設し、両者の知見を融合した技術開発および開発技術の社会実装、人材育成についての取り組みを開始しました。	製品化・サービス化
株式会社ZMPは、物流支援ロボットCarriRoと株式会社YE DIGITAL、が提供する「MMLogiStation」の連携を発表します。	その他
ゼンハイザージャパンは、クリエーターやビデオグラファー、モバイルジャーナリストが動画の音質を向上させるオンカメラマイク「MKE 400-II」とスマートホンクランプおよびミニ三脚を付属した「MKE 400-II Mobile Kit」を2022年1月27日より発売する。	製品化・サービス化
両備ホールディングスは13日、車内に星空を投影する「プラネタリウムバス」の運行を始めた。	製品化・サービス化
伊豫さんは東京海洋大大学院時代、野生動物に全地球測位システムなど小型の計測器を付けて生態を調査する「バイオロギング」を研究。	製研究・開発
観光関連ウェブサイト制作などのフィールドデザインとシステム開発のアドバンステクノロジーは、中小観光事業者や観光協会向けの旅行予約管理システムを開発した。	製研究・開発
このような中、東日本電信電話株式会社神奈川事業部と神奈川県内で畜産業を営み、「あつぎ豚」等を生産している有限会社臼井農産および「相州牛」を生産している株式会社長崎牧場は、日本電信電話株式会社アクセスサービスシステム研究所の協力を得て、「スマート畜産」普及に向けた無線通信環境の通信品質に関する実証実験を開始した。	製研究・開発
日本エスコンは、相模原市緑区橋本の再開発エリア近接地で分譲マンション3棟を建設する。	製品化・サービス化
新商品金沢市大野町の株式会社ヤマト醤油味噌は、味噌・醤油の醸造に加えて、発酵食のテーマパーク「ヤマト・糀パーク」を展開。	製品化・サービス化
KDDIは、au PAYアプリ上でタクシーの配車・決済ができるミニアプリ「au Moves、タクシー」の提供を、2月1日に開始した。	製品化・サービス化
以下たまるモール)は、株式会社トーシンパートナーズが運営する「医師・医療従事者向け資産形成コンサルティングサービス「パーソナルアセットパートナー」の掲載を開始しました。	製品化・サービス化
パナソニック株式会社は、新設計「セットナビカゴ」により、食器をセットする位置がわかりやすく、出し入れしやすくなった卓上型食器洗い乾燥機NP-TR7を5月1日より発売します。	製品化・サービス化
アステリア株式会社は、ノーコード1のモバイルアプリ作成ツール「Platio」が、大型家電・家具の発送・設置などの運輸業を手がける株式会社コネクストに導入されたことを発表します。	製品化・サービス化
